	das wesentliche | the essentials
das wesentliche | the essentials

rot | red
grün | green
blau | blue
schwarz | black
weiß | white
gelb | yellow

		das wesentliche | the basics
das wesentliche | the basics

Hallo. | Hello.
Hallo! | Hi!
Guten Morgen. | Good morning.
Guten Tag. | Good afternoon.
Guten Abend. | Good evening.
Gute Nacht. | Goodnight.
Bis bald. | See you soon.
Bis morgen. | See you tomorrow.
Bis Samstag. | See you on Saturday.
Tschüss! | Bye!
Schönen Tag / Abend! | Have a good day / evening!

Ja. | Yes.
Nein. | No.
Ich weiß nicht. | I don't know.
Bitte. | Please.
Ja, bitte. | Yes, please.
Vielen Dank. | Thank you.
Nein, danke. | No, thanks.
Entschuldigung. | Excuse me.
Wie bitte? | Sorry?
Es tut mir leid. | I'm sorry.
Einverstanden! | OK!
Bitte. | You're welcome.
Ich verstehe nicht. | I don't understand.

		über sie | about you
über sie | about you

Wie alt sind Sie? | How old are you?
Darf ich fragen, wie alt Sie sind? | May I ask how old you are?
Wann haben Sie Geburtstag? | When is your birthday?
Ich bin ... (Jahre alt). | I'm ... years old.
Ich habe am ... Geburtstag. | My birthday is on...
Ich bin ... geboren. | I was born in...
Ich bin älter / jünger als... | I'm older / younger than...
Wo kommen Sie her? | Where are you from?
Wo wohnen Sie? | Where do you live?
Ich komme aus... | I'm from...
... dem Vereinigten Königreich. | ... the UK.
Ich wohne in... | I live in...
Ich bin... | I'm...
schottisch | Scottish
englisch | English
irisch | Irish
walisisch | Welsh
britisch | British
Sind Sie verheiratet / ledig? | Are you married / single?
Ich bin verheiratet. | I'm married.
Ich habe einen Partner / eine Partnerin. | I have a partner.
Ich bin ledig. | I'm single.
Ich bin geschieden. | I'm divorced.
Ich bin verwitwet. | I'm widowed.
Haben Sie Kinder? | Do you have any children?
Ich habe ... Kinder. | I have ... children.
Ich bin kinderlos | I don't have any children.

		familie und freunde | family and friends
familie und freunde | family and friends

Das ist mein / meine... | This is my...
Das sind meine... | These are my...
der Ehemann | husband
die Ehefrau | wife
der Freund | boyfriend
die Freundin | girlfriend
der Partner / die Partnerin | partner
der Verlobte / die Verlobte | fiancé / fiancée
der Sohn | son
die Tochter | daughter
die Eltern | parents
der Vater | father
die Mutter | mother
der Bruder | brother
die Schwester | sister
der Großvater | grandfather
die Großmutter | grandmother
der Enkelsohn | grandson
die Enkelin | granddaughter
der Schwiegervater | father-in-law
die Schwiegermutter | mother-in-law
die Schwiegertochter | daughter-in-law
der Schwiegersohn | son-in-law
der Schwager | brother-in-law
die Schwägerin | sister-in-law
der Stiefvater | stepfather
die Stiefmutter | stepmother
der Stiefsohn | stepson
die Stieftochter | stepdaughter
der Onkel | uncle
die Tante | aunt
der Neffe | nephew
die Nichte | niece
der Cousin / die Cousine | cousin
die Großfamilie | extended family
der Freund / die Freundin | friend
der Kollege / die Kollegin | colleague
das Baby | baby
das Kind | child
der Teenager | teenager

		gesundheit und wohlbefinden | general health and wellbeing
gesundheit und wohlbefinden | general health and wellbeing

Wie geht es Ihnen? | How are you?
Wie geht's? | How's it going?
Wie geht es ihm / ihr? | How is he / she?
Wie geht es ihnen? | How are they?
Sehr gut, danke, und Ihnen? | Very well, thanks, and you?
Danke, gut. | Fine, thanks.
Super! | Great!
So lala. | So-so.
Nicht schlecht, danke. | Not bad, thanks.
Es geht so. | Could be worse.
Mir geht es gut. | I'm fine.
Ich bin müde. | I'm tired.
Ich habe Hunger / Durst. | I'm hungry / thirsty.
Ich bin satt. | I'm full.
Mir ist kalt / warm. | I'm cold / warm.
Ich bin... | I am...
Er / Sie ist... | He / She is...
Sie sind... | They are...
glücklich | happy
aufgeregt | excited
ruhig | calm
überrascht | surprised
verärgert | annoyed
wütend | angry
traurig | sad
besorgt | worried
verängstigt | afraid
gelangweilt | bored
Ich fühle mich... | I feel...
Er / Sie fühlt sich... | He / She feels...
Sie fühlen sich... | They feel...
gut | well
unwohl | unwell
besser | better
schlechter | worse

		arbeit | work
arbeit | work

Wo arbeiten Sie? | Where do you work?
Was machen Sie beruflich? | What do you do?
Was ist Ihr Beruf? | What's your occupation?
Arbeiten / Studieren Sie? | Do you work / study?
Ich bin selbstständig. | I'm self-employed.
Ich bin arbeitslos. | I'm unemployed.
Ich bin an der Universität. | I'm at university.
Ich bin im Ruhestand. | I'm retired.
Ich reise. | I'm travelling.
Ich arbeite zu Hause. | I work from home.
Ich habe eine Teilzeit- / Vollzeitbeschäftigung. | I work part- / full-time.
Ich arbeite als... | I work as a / an...
Ich bin... | I'm a / an...
der Maurer / die Maurerin | builder
der Koch / die Köchin | chef
der Beamter / die Beamtin | civil servant
der Zahnarzt / die Zahnärztin | dentist
der Arzt / die Ärztin | doctor
der Fahrer / die Fahrerin | driver
der Elektriker / die Elektrikerin | electrician
der Ingenieur / die Ingenieurin | engineer
der Bauer / die Bäuerin | farmer
der Feuerwehrmann / die Feuerwehrfrau | firefighter
der Fischer / die Fischerin | fisherman
der Informatiker / die Informatikerin | IT worker
der Tischler / die Tischlerin | joiner
der Journalist / die Journalistin | journalist
der Rechtsanwalt / die Rechtsanwältin | lawyer
der Dozent / die Dozentin | lecturer
der Mechaniker / die Mechanikerin | mechanic
der Krankenpfleger / die Krankenschwester | nurse
der / die Büroangestellte | office worker
der Klempner / die Klempnerin | plumber
der Polizeibeamte / die Polizeibeamtin | police officer
der Briefträger / die Briefträgerin | postal worker
der Matrose / die Matrosin | sailor
der Verkäufer / die Verkäuferin | salesperson
der Wissenschaftler / die Wissenschaftlerin | scientist
der Soldat / die Soldatin | soldier
der Lehrer / die Lehrerin | teacher
der Tierarzt / die Tierärztin | vet
der Kellner | waiter
die Kellnerin | waitress
Ich arbeite bei... | I work at / in...
das Geschäft | business
die Firma | company
die Baustelle | construction site
die Fabrik | factory
die Regierung | government
das Krankenhaus | hospital
das Hotel | hotel
das Büro | office
das Restaurant | restaurant
die Schule | school
der Laden | shop

		die uhrzeit | time
die uhrzeit | time

der Morgen | morning
der Nachmittag | afternoon
der Abend | evening
die Nacht | night
der Mittag | midday
die Mitternacht | midnight
Wie spät ist es? | What time is it?
Es ist neun Uhr. | It's nine o'clock.
Es ist zehn nach neun. | It's ten past nine.
Es ist Viertel nach neun. | It's quarter past nine.
Es ist fünf vor halb zehn. | It's 25 past nine.
Es ist halb zehn. | It's half past nine.
Es ist zwanzig vor zehn. | It's 20 to ten.
Es ist Viertel vor zehn. | It's quarter to ten.
Es ist fünf vor zehn. | It's five to ten.
Es ist zehn Uhr (morgens). | It's 10 a.m.
Es ist fünf Uhr (abends). | It's 5 p.m.
Es ist siebzehn Uhr dreißig. | It's 17:30.
Wann...? | When...?
... in 60 Sekunden / zwei Minuten. | ... in 60 seconds / two minutes.
... in einer Stunde / halben Stunde. | ... in an hour / half an hour.
... in einer Viertelstunde. | ... in quarter of an hour.
heute | today
heute Abend | tonight
morgen | tomorrow
gestern | yesterday
übermorgen | the day after tomorrow
vorgestern | the day before yesterday
früh | early
verspätet | late
bald | soon
später | later
jetzt | now

		tage, monate und jahreszeiten | days, months, and seasons
tage, monate und jahreszeiten | days, months, and seasons

Montag | Monday
Dienstag | Tuesday
Mittwoch | Wednesday
Donnerstag | Thursday
Freitag | Friday
Samstag | Saturday
Sonntag | Sunday
Januar | January
Februar | February
März | March
April | April
Mai | May
Juni | June
Juli | July
August | August
September | September
Oktober | October
November | November
Dezember | December
der Tag | day
das Wochenende | weekend
die Woche | week
die zwei Wochen | fortnight
der Monat | month
das Jahr | year
das Jahrzehnt | decade
täglich | daily
wöchentlich | weekly
alle zwei Wochen | fortnightly
monatlich | monthly
jährlich | yearly
montags | on Mondays
jeden Sonntag | every Sunday
am letzten / nächsten Donnerstag | last / next Thursday
die vorletzte Woche | the week before
die übernächste Woche | the week after
im Februar | in February
in 2019 | in 2019
Welches Datum haben wir? | What is today's date?
der Frühling | spring
der Sommer | summer
der Herbst | autumn
der Winter | winter
im Frühling / Winter | in spring / winter

		das wetter | weather
das wetter | weather

Wie ist das Wetter? | How's the weather?
Wie ist die Wettervorhersage für heute / morgen? | What's the forecast for today / tomorrow?
Ist es warm / kalt? | How warm / cold is it?
Wird es regnen? | Is it going to rain?
So ein schöner Tag! | What a lovely day!
Was für furchtbares Wetter! | What awful weather!
Es ist sonnig. | It's sunny.
Es ist bewölkt / dunstig. | It's cloudy / misty.
Es ist neblig. | It's foggy.
Es friert. | It's freezing.
Es regnet / schneit. | It's raining / snowing.
Es ist windig. | It's windy.
Es ist stürmisch. | It's stormy.
Es ist wechselhaft. | It's changeable.
Es ist... | It is...
schön | nice
schlecht | horrible
heiß | hot
warm | warm
kühl | cool
nass | wet
schwül | humid
mild | mild
die Temperatur | temperature
die Sonne | sun
der Regen | rain
der Schnee | snow
der Hagel | hail
das Eis | ice
der Wind | wind
der Sturm | gale
der Dunst | mist
der Nebel | fog
der Donner | thunder
der Blitz | lightning
das Gewitter | thunderstorm
die Wolke | cloud

		die zahlen | numbers
die zahlen | numbers
eins | 1
zwei | 2
drei | 3
vier | 4
fünf | 5
sechs | 6
sieben | 7
acht | 8
neun | 9
zehn | 10
elf | 11
zwölf | 12
dreizehn | 13
vierzehn | 14
fünfzehn | 15
sechzehn | 16
siebzehn | 17
achtzehn | 18
neunzehn | 19
zwanzig | 20
dreißig | 30
vierzig | 40
fünfzig | 50
sechzig | 60
siebzig | 70
achtzig | 80
neunzig | 90
hundert | 100
tausend | 1 000
Million | 1 000 000

	verkehrsmittel | transport
verkehrsmittel | transport

der Hubschrauber | helicopter
der Rotor | rotor
das Rotorblatt | blade
die Nase | nose
das Cockpit | cockpit
das Heck | tail

		das wesentliche | the basics

die Straße | street
der Pendler / die Pendlerin | commuter
der Fahrer / die Fahrerin | driver
der Passagier / die Passagierin | passenger
der Fußgänger / die Fußgängerin | pedestrian
der Verkehr | traffic
der Verkehrsstau | traffic jam
die Hauptverkehrszeit | rush hour
die öffentlichen Verkehrsmittel; ntpl | public transport
das Taxi | taxi
der Taxistand | taxi rank
die Anweisungen; fpl | directions
die Strecke | route
gehen | to walk
fahren | to drive
zurückkehren | to return
überqueren | to cross
umdrehen | to turn
pendeln | to commute
die Landkarte | map
die Fahrkarte | ticket
der Zeitplan | timetable

		mit dem auto | car
mit dem auto | car

der Minivan | people carrier
das Wohnmobil | motorhome
der Wohnwagen | caravan
der Beifahrersitz | passenger seat
der Fahrersitz | driver's seat
der Rücksitz | back seat
der Kindersitz | child seat
der Dachgepäckträger | roof rack
das Schiebedach | sunroof
die Automatik | automatic
das Elektroauto | electric car
das Hybridauto | hybrid
der Motor | engine
die Batterie | battery
die Bremse | brake
das Gaspedal | accelerator
die Klimaanlage | air conditioning
die Kupplung | clutch
der Tempomat | cruise control
das Auspuffrohr | exhaust (pipe)
der Benzintank | fuel tank
das Schaltgetriebe | gearbox
das Getriebe | transmission
der Promillemesser | Breathalyser®
den Motor anlassen | to start the engine
bremsen | to brake
überholen | to overtake
parken | to park
zurücksetzen | to reverse
verlangsamen | to slow down
die Geschwindigkeit überschreiten | to speed
anhalten | to stop

der Kofferraum | boot
das Dach | roof
das Fenster | window
das Rad | wheel
die Tür | door
der Kotflügel | wing
der Autoreifen | tyre
die Motorhaube | bonnet
die Windschutzscheibe | windscreen
der Scheibenwischer | windscreen wiper
der Seitenspiegel | wing mirror
der Scheinwerfer | headlight
die Stoßstange | bumper
das Nummernschild | number plate
der Blinker | indicator

das Armaturenbrett | dashboard
die Tankanzeige | fuel gauge
der Schaltknüppel | gearstick
das Handschuhfach | glove compartment
die Handbremse | handbrake
die Kopfstütze | headrest
die Zündung | ignition
der Rückspiegel | rearview mirror
das Navi | sat nav
der Sicherheitsgurt | seatbelt
der Tachometer | speedometer
das Lenkrad | steering wheel

		das fahren | driving
das fahren | driving
die Schnellstraße | dual carriageway
die einspurige Landstraße | single-track road
der Asphalt | tarmac®
die Ecke | corner
die Ausfahrt | exit
die Zufahrtsstraße | slip road
die Parkbucht | layby
die Geschwindigkeitsbegrenzung | speed limit
die Umleitung | diversion
der Führerschein | driving licence
der Fahrzeugschein | car registration document
die Kraftfahrzeugversicherung | car insurance
die Autovermietung | car hire / rental
das bleifreie Benzin | unleaded petrol
der Diesel | diesel
die Straßenarbeiten; fpl | roadworks
der Behindertenparkplatz | accessible parking space
die Brücke | bridge
der Parkplatz | car park
die Autowaschanlage | car wash
die Zapfsäule | fuel pump
die Kreuzung | junction
die Bordkante | kerb
die Fahrspur | lane
der Bahnübergang | level crossing
die Autobahn | motorway
die Parkuhr | parking meter
die Parklücke | parking space
der Bürgersteig | pavement
die Tankstelle | petrol station
das Schlagloch | pothole
die Straße | road
der Kreisverkehr | roundabout
die Raststätte | service area
die Geschwindigkeitskamera | speed camera
der Pylon | traffic cone
die Verkehrsampel | traffic lights
der Verkehrspolizist / die Verkehrspolizistin | traffic warden
der Tunnel | tunnel
der Zebrastreifen | zebra crossing

		probleme mit dem auto | car trouble
probleme mit dem auto | car trouble
der Unfall | accident
die Panne | breakdown
der Zusammenstoß | collision
der platte Reifen | flat tyre
kaputtgehen | to break down
einen Unfall haben | to have an accident
einen platten Reifen haben | to have a flat tyre
den Reifen wechseln | to change a tyre
abschleppen | to tow
der Airbag | airbag
das Frostschutzmittel | antifreeze
das Notruftelefon | emergency phone
die Garage | garage
die Warnweste | hi-viz vest
der Wagenheber | jack
die Starthilfekabel; ntpl | jump leads
der Mechaniker / die Mechanikerin | mechanic
die Schneeketten; fpl | snow chains
das Reserverad | spare wheel
der Abschleppwagen | tow truck
das Warndreieck | warning triangle

		mit dem bus | bus
mit dem bus | bus
die Buslinie | bus route
die Busspur | bus lane
der Busbahnhof | bus station
der Fahrpreis | fare
der volle Fahrpreis | full fare
der halbe Fahrpreis | half fare
die Ermäßigung | concession
der Rollstuhlzugang | wheelchair access
der Nachtbus | night bus
der Shuttlebus | shuttle bus
der Schulbus | school bus
der Flughafenbus | airport bus
der Reisebus | tour bus
den Bus nehmen | to catch the bus
der Bus | bus
das Wartehäuschen | bus shelter
die Bushaltestelle | bus stop
der Reisebus | coach
der Kleinbus | minibus
der Trolleybus | trolley bus

		mit dem fahrrad | bicycle
mit dem fahrrad | bicycle
der Radfahrer / die Radfahrerin | cyclist
das Mountainbike | mountain bike
das Rennrad | road bike
das Hybridrad | hybrid bike
der Fahrradständer | bike stand
der Fahrradträger | bike rack
der Kindersitz | child seat
der Fahrradweg | cycle lane
der Radweg | cycle path
das Reparaturkästchen | puncture repair kit
die Warnweste | reflective vest
die Radlerhose | cycling shorts
radfahren | to cycle
eine Fahrradfahrt machen | to go for a bike ride

die Klingel | bell
das Fahrradschloss | bike lock
der Frontscheinwerfer | front light
der Helm | helmet
die Fahrradpumpe | pump
der Reflektor | reflector

die Bremse | brake
die Lenkstange | handlebars
die Gänge; mpl | gears
die Querstange | crossbar
der Sattel | saddle
der Rahmen | frame
das Pedal | pedal
die Kette | chain
das Rad | wheel
der Radreifen | tyre

		mit dem motorrad | motorbike
mit dem motorrad | motorbike
der Motorradfahrer / die Motorradfahrerin | motorcyclist
das Moped | moped
der Roller | scooter
der Benzintank | fuel tank
die Lenkstange | handlebars
der Scheinwerfer | headlight
der Kotflügel | mudguard
der Seitenständer | kickstand
die Lederbekleidung | leathers
die Stiefel; mpl | boots
der Sturzhelm | crash helmet
die Helmkamera | helmet cam
die Lederhandschuhe; mpl | leather gloves
die Lederjacke | leather jacket
das Motorrad | motorbike

		mit dem zug | rail travel
mit dem zug | rail travel
das Eisenbahnnetz | rail network
der Hochgeschwindigkeitszug | high-speed train
der Personenzug | passenger train
der Güterzug | freight train
der Nachtzug | sleeper
der Wagen | coach
die Linie | line
die U-Bahnstation | metro station
die Gepäckaufbewahrung | left luggage
die Bahnkarte | railcard
die einfache Fahrkarte | single ticket
die Rückfahrkarte | return ticket
das Online-Ticket | e-ticket
prioritär | first-class
der Ruhebereich | quiet coach
die Sitzplatzreservierung | seat reservation
umsteigen | to change trains
eine Fahrkarte entwerten | to validate a ticket
der Wagen | carriage
der Liegeplatz | couchette
der Anzeigetafel | departure board
der Bahnbeamte / die Bahnbeamtin | guard
die S-Bahn | light railway
die Lokomotive | locomotive
die Gepäckablage | luggage rack
die U-Bahn | metro
der Bahnsteig | platform
der Gepäckträger / die Gepäckträgerin | porter
das Bordrestaurant | restaurant car
das Stellwerk | signal box
die Schiebetüren; fpl | sliding doors
die Fahrkartensperre | ticket barrier
der Fahrscheinautomat | ticket machine
der Fahrkartenschalter | ticket office
die Schienen; fpl | track
der Zug | train
der Bahnhof | train station
die Straßenbahn | tram
der Entwerter | validation machine

		mit dem flugzeug | air travel
mit dem flugzeug | air travel
die Fluglinie | airline
der Terminal | terminal
Ankünfte / Abflüge | Arrivals / Departures
der Sicherheitsdienst | security
die Passkontrolle | passport control
die Zollabfertigung | customs
das Flugbegleitpersonal | cabin crew
die Business Class | business class
die Touristenklasse | economy class
der Gang | aisle
der Klapptisch | tray table
das Gepäckfach | overhead locker
der Sicherheitsgurt | seatbelt
die Tragfläche | wing
die Maschine | engine
der Rumpf | fuselage
der Frachtraum | hold
das aufgegebene Gepäck | hold luggage
das Übergepäck | excess baggage
das Handgepäck | hand / cabin baggage
der Anschlussflug | connecting flight
der Jetlag | jetlag
(Online) einchecken | to check in (online)
das Flugzeug | aeroplane
der Flughafen | airport
die Gepäckausgabe | baggage reclaim
die Bordkarte | boarding card
die Kabine | cabin
der Check-inSchalter | check-in desk
das Cockpit | cockpit
die Anzeigetafel | departure board
der Duty-free-Shop | duty-free shop
die Reisetasche | holdall
der Kofferkuli | luggage trolley
der Reisepass | passport
der Pilot / die Pilotin | pilot
die Landebahn | runway
der Koffer | suitcase

		fähre und boot | ferry and boat travel
fähre und boot | ferry and boat travel
die Überfahrt | ferry crossing
der Fährhafen | ferry terminal
das Autodeck | car deck
das Deck | deck
der Schornstein | funnel
das Bullauge | porthole
das Rettungsboot | lifeboat
der Bug | bow
das Heck | stern
der Hafen | port
der Jachthafen | marina
der Kanal | canal
die Küstenwache | coastguard
der Kapitän | captain
die Besatzung | crew
der Fußpassagier / die Fußpassagierin | foot passenger
an Bord gehen | to board
auslaufen | to sail
anlegen | to dock

der Anker | anchor
die Boje | buoy
die Gangway | gangway
der Hafen | harbour
der Hafendamm | jetty
der Rettungsring | lifebuoy
die Schwimmweste | lifejacket
die Schleuse | lock
der Anlegeplatz | mooring

das Kanalboot | canal boat
das Kanu | canoe
die Fähre | ferry
das Schlauchboot | inflatable dinghy
das Kajak | kayak
das Passagierschiff | liner
das Ruderboot | rowing boat
das Segelboot | sailing boat
die Jacht | yacht


	im haus | in the home
im haus | in the home

der Wohnblock | block of flats

		das wesentliche | the basics

das Reihenhaus | terraced house
das Stadthaus | townhouse
die Villa | villa
das Gebäude | building
die Adresse | address
der Vorort | suburb
der Bezirk | district
der Makler / die Maklerin | letting agent
der Immobilienhändler / die Immobilienhändlerin | estate agent
der Vermieter | landlord
die Vermieterin | landlady
der Mieter / die Mieterin | tenant
der Nachbar / die Nachbarin | neighbour
die Hypothek | mortgage
die Miete | rent
der Mietvertrag | rental agreement
die Urlaubsvermietung | holiday let
mieten | to rent
besitzen | to own
wohnen | to live
umziehen | to move house
ein Haus bauen | to build a house

der Wohnblock | apartment block
der Bungalow | bungalow
das Einzelhaus | detached house
der Bauernhof | farmhouse
das Doppelhaus | semi-detached house
die Einzimmerwohnung | studio flat

		das haus | the house
das haus | the house
das Zimmer | room
der Keller | cellar
der Dachboden | attic
die Decke | ceiling
die Wand | wall
der Boden | floor
die Veranda | porch
die Hintertür | back door
die Fenstertür | French windows
der Balkon | balcony
das Oberlicht | skylight
die Batterie | battery
der Stecker | plug
der Adapter | adaptor
die Steckdose | socket
die Elektrizität | electricity
die Klimaanlage | air conditioning
die Zentralheizung | central heating
die Parabolantenne | satellite dish
der Stromausfall | power cut
der Fensterputzer / die Fensterputzerin | window cleaner
reparieren | to fix
dekorieren | to decorate
renovieren | to renovate

der Boiler | boiler
der Deckenventilator | ceiling fan
das Verlängerungskabel | extension cable
der Sicherungskasten | fusebox
der Heizkörper | heater
die Glühbirne | light bulb
der Stromzähler | meter
der Heizkörper | radiator
der Sicherheitsalarm | security alarm
der Rauchmelder | smoke alarm
das Thermostat | thermostat
der Holzofen | wood-burning stove

das Dach | roof
der Schornstein | chimney
die Antenne | aerial
die Regenrinne | gutter
das Abflussrohr | drainpipe
der Giebel | gable
das Fenster | window
der Fensterladen | shutter
das Tor | gate
die Auffahrt | driveway
die Haustür | front door
die Garage | garage

		der eingang | the entrance
der eingang | the entrance

die Haustür | front door
der Eingang | doorway
der Flur | hallway / corridor
der Treppenabsatz | landing
das Treppenhaus | stairwell
die Treppe | staircase
der Aufzug | lift
die Fußmatte | doormat
der Schlüssel | key
jemanden mit dem Summer hereinlassen | to buzz somebody in
sich die Füße abtreten | to wipe one's feet
die Jacke aufhängen | to hang one's jacket up
die Türklingel | doorbell
die Sprechanlage | intercom
der Briefkasten | letterbox

		das wohnzimmer | the lounge
das wohnzimmer | the lounge

der Teppich | carpet
die Dielen; fpl | floorboards
die Garnitur | suite
das Schlafsofa | sofa bed
die Tischlampe | table lamp
das HomeEntertainmentSystem | home entertainment system
das Kabelfernsehen | cable TV
das Satellitenfernsehen | satellite TV
das Fernsehen auf Abruf | TV on demand
sich entspannen | to relax
sich setzen | to sit down
fernsehen | to watch TV

das Bücherregal | bookcase
die Vorhänge; mpl | curtains
die Vitrine | display cabinet
der DVD­Player / Blu­ray­Player® | DVD / Blu-ray® player
das Radio | radio
die Fernbedienung | remote control
die Anrichte | sideboard
der Fernsehschrank | TV stand
die Jalousie | Venetian blind

die Wandleuchte | wall light
der Fernseher | TV
der Kamin | fireplace
der Couchtisch | coffee table
das Sofa | sofa
das Bild | picture
das Ornament | ornament
das Regal | shelves
der Sessel | armchair
der Schemel | footstool
der Teppich | rug
das Kissen | cushion

		die küche | the kitchen
die küche | the kitchen

der Kessel | kettle
der Toaster | toaster
der Elektroherd | electric cooker
der Gasherd | gas cooker
die Abzugshaube | cooker hood
kochen | to cook
braten | to fry
(unter Rühren) kurz anbraten | to stir-fry
kochen | to boil
braten | to roast
backen | to bake
das Geschirr spülen | to wash up
die Arbeitsfläche saubermachen | to clean the worktops
groceries | to put away the
einräumen | die Einkäufe

das Backblech | baking tray
die Pressfilterkanne | cafetière
der Schmortopf | casserole dish
das Hackbrett | chopping board
das Sieb | colander
der Korkenzieher | corkscrew
die Küchenmaschine | food processor
die Bratpfanne | frying pan
die Reibe | grater
der Handmixer | hand mixer
das Küchenmesser | kitchen knife
der Schöpflöffel | ladle
der Kartoffelstampfer | masher
der Messbecher | measuring jug
die Rührschüssel | mixing bowl
der Schäler | peeler
das Nudelholz | rolling pin
der Kochtopf | saucepan
das Sieb | sieve
der Spachtel | spatula
der Dosenöffner | tin opener
der Schneebesen | whisk
der Wok | wok
der Holzlöffel | wooden spoon

die Alufolie | aluminium foil
die Mülltüte | bin bag
der Brotkasten | bread bin
die Frischhaltefolie | clingfilm
das Küchenpapier | kitchen roll
der Treteimer | pedal bin

die Spüle | sink
der Backofen | oven
das Kochfeld | hob
der Mikrowellenherd | microwave
die Kühl­GefrierKombination | fridge-freezer
der Schrank | cupboard
der Wasserhahn | tap
das Abtropfbrett | draining board
die Schublade | drawer
die Arbeitsfläche | worktop
die Fliesen; fpl | tiles

		das esszimmer | the dining room
das esszimmer | the dining room
der Esstisch | dining table
das Set | place mat
der Untersetzer | coaster
das Geschirr | crockery
das Besteck | cutlery
das Glasgeschirr | glassware
den Tisch decken | to set the table
zu Abend essen | to dine
den Tisch abräumen | to clear the table
die Sauciere | gravy boat
die Serviette | napkin
die Pfeffermühle | pepper mill
die Salatschüssel | salad bowl
der Salzstreuer | salt cellar
der Servierteller | serving dish

die Schüssel | bowl
die Sektflöte | champagne flute
die Tasse und die Untertasse | cup and saucer
das Messer und die Gabel | knife and fork
der Teller | plate
der Löffel | spoon
der Teelöffel | teaspoon
das Trinkglas | tumbler
das Weinglas | wine glass

		das schlafzimmer | the bedroom
das schlafzimmer | the bedroom
das Einzelbett | single bed
das Doppelbett | double bed
das Hauptschlafzimmer | master bedroom
das Gästezimmer | spare room
das eigene Bad | en-suite bathroom
das Kinderzimmer | nursery
die Bettwäsche | bedding
ins Bett gehen | to go to bed
schlafen | to sleep
aufwachen | to wake up
das Bett machen | to make the bed
die Laken wechseln | to change the sheets

die Decke | blanket
das Etagenbett | bunk beds
der Radiowecker | clock radio
der Kleiderbügel | coat hanger
die Frisierkommode | dressing table
der Föhn | hairdryer
der Wäschekorb | laundry basket
die Bettdecke | quilt
die Laken; ntpl | sheets

der Spiegel | mirror
die Kommode | chest of drawers
das Bett | bed
der Kleiderschrank | wardrobe
die Bettdecke | duvet
die Vorhänge; mpl | curtains
der Sessel | armchair
die Nachttischlampe | bedside lamp
der Teppich | rug
das Kopfkissen | pillow
die Matratze | mattress
der Nachttisch | bedside table

		das bad | the bathroom
das bad | the bathroom

der Duschvorhang | shower curtain
die Toilettenartikel; mpl | toiletries
der Abfluss | drain
duschen | to shower
baden | to have a bath
sich die Hände waschen | to wash one's hands
sich die Zähne putzen | to brush one's teeth
auf die Toilette gehen | to go to the toilet

die Badematte | bath mat
das Badetuch | bath towel
der Waschlappen | face cloth
das Handtuch | hand towel
der Duschpuschel | shower puff
die Seife | soap
der Schwamm | sponge
die Klobürste | toilet brush
die Rolle Toilettenpapier | toilet roll

der Spiegel | mirror
das Waschbecken | sink
die Dusche | shower
die Toilette | toilet
der Handtuchhalter | towel rail
der Wasserhahn | tap
das Schränkchen | cabinet
das Bidet | bidet
die Duschabtrennung | shower screen
die Badewanne | bath

		der garten | the garden
der garten | the garden
der Baum | tree
die Erde | soil
das Gras | grass
die Pflanze | plant
das Unkraut | weed
das Blumenbeet | flowerbed
der Kompost | compost
der Kleingarten | allotment
der Gärtner / die Gärtnerin | gardener
jäten | to weed
gießen | to water
anpflanzen | to grow
pflanzen | to plant

die Terrasse | decking
die Forke | garden fork
der Gartenschlauch | garden hose
die Gartenhandschuhe; mpl | gardening gloves
das Gartenhaus | garden shed
das Gewächshaus | greenhouse
die Hacke | hoe
der Rasenmäher | lawnmower
der Sonnenschirm | parasol
der Blumentopf | plant pot
die Gartenschere | pruners
der Spaten | spade
die Kelle | trowel
die Gießkanne | watering can
der Unkrautvernichter | weedkiller
die Gummistiefel; mpl | Wellington boots
der Schubkarren | wheelbarrow
der Blumenkasten | windowbox

das Spalier | trellis
der Rasen | lawn
der Strauch | shrub
das Tor | gate
der Zaun | fence
das Vogelhäuschen | birdbox
die Gartenmöbel; ntpl | patio furniture
der Pfad | path
die Blumen; fpl | flowers
die Terrasse | patio
der Blumentopf | flowerpot

		die hausarbeit | housework
die hausarbeit | housework
der Hauswirtschaftsraum | utility room
die Haushaltsgeräte; ntpl | household appliances
die Hausarbeit | chores
das Becken | basin
der Recyclingbehälter | recycling bin
der Papierkorb | wastepaper basket
die Bleiche | bleach
das Desinfektionsmittel | disinfectant
das Spülmaschinentab | dishwasher tablet
das Waschmittel | laundry detergent
das Spülmittel | washing-up liquid
kehren | to sweep the floor
die Wäsche waschen | to do the laundry
staubsaugen | to hoover
aufräumen | to tidy up
reinigen | to clean
der Besen | brush
der Eimer | bucket
der Lappen | cloth
der Wäscheständer | clothes horse
die Wäscheklammern; fpl | clothes pegs
die Geschirrspülmaschine | dishwasher
der Mülleimer | dustbin
die Kehrschaufel | dustpan
das Bügeleisen | iron
das Bügelbrett | ironing board
der Mop | mop
die Gummihandschuhe; mpl | rubber gloves
der Topfreiniger | scourer
das Geschirrtuch | tea towel
der Wäschetrockner | tumble drier
der Staubsauger | vacuum cleaner
die Wäscheleine | washing line
die Waschmaschine | washing machine

	im laden | at the shops
im laden | at the shops

		das wesentliche | the basics

der Laden | shop
der Supermarkt | supermarket
das Einkaufszentrum | shopping centre
der Verkäufer / die Verkäuferin | shop assistant
der Kunde / die Kundin | customer
der Markt | market
das Bargeld | cash
das Wechselgeld | change
kontaktlos | contactless
der Geschenkgutschein | gift voucher
die Paybackkarte | loyalty card
die PIN | PIN
der Umtausch | exchange
die Rückerstattung | refund
der Gutschein | voucher
die Lebensmittel; ntpl | groceries
sich umsehen | to browse
kaufen | to buy
zahlen | to pay
(Online) einkaufen | to shop (online)
einkaufen gehen | to go shopping
die Banknoten; fpl | banknotes
der Kartenleser | card reader
die Münzen; fpl | coins
die Bankkarte / Kreditkarte | debit / credit card
die Papiertüte | paper bag
die Plastiktüte | plastic bag
die Quittung | receipt
die wiederverwendbare Einkaufstasche | reusable shopping bag
die Kasse | till point

		der supermarkt | supermarket
der supermarkt | supermarket
der Gang | aisle
das Feinkostgeschäft | delicatessen
das Fertiggericht | ready meal
die Flasche | bottle
die Schachtel | box
der Pappkarton | carton
das Einmachglas | jar
der Multipack | multipack
das Päckchen | packet
die Dose | tin
konserviert | tinned
frisch | fresh
tiefgefroren | frozen
Milch- | dairy
fettarm | low-fat 
kalorienarm | low-calorie
glutenfrei | gluten-free

der Korb | basket
die Waage | scales
der Einkaufswagen | trolley

die Kekse; mpl | biscuits
der Couscous | couscous
die Kräuter; ntpl | herbs
der Honig | honey
der Puderzucker | icing sugar
der lösliche Kaffee | instant coffee
die Marmelade | jam
das Ketchup | ketchup
die Orangenmarmelade | marmalade
die Mayonnaise | mayonnaise
der Senf | mustard
die Nudeln; fpl | noodles
das Olivenöl | olive oil
die Nudeln; fpl | pasta
der Pfeffer | pepper
der Reis | rice
das Salz | salt
der Zucker | sugar
die Teebeutel; mpl | teabags
das Pflanzenöl | vegetable oil
der Essig | vinegar

die Schokolade | chocolate
die Kartoffelchips; mpl | crisps
die Nüsse; fpl | nuts
die Oliven; fpl | olives
das Popcorn | popcorn
die Süßigkeiten; fpl | sweets

das Bier | beer
die Limo | fizzy drink
der Fruchtsaft | fruit juice
das Mineralwasser | mineral water
die Spirituosen pl | spirits
der Wein | wine

		der markt | market
der markt | market
der Marktplatz | marketplace
der Flohmarkt | flea market
die Markthalle | indoor market
der Bauernmarkt | farmer's market
der Stand | stall
der Händler / die Händlerin | trader
die Produkte; ntpl | produce
örtlich | local
bio | organic
saisonbedingt | seasonal
selbstgemacht | home-made

		obst und gemüse | fruit and vegetables
obst und gemüse | fruit and vegetables
der Gemüseladen | greengrocer's
der Saft | juice
das Blatt | leaf
die Schale | peel
der Obstkern | pip
die Schale | rind
der Kern | seed
der Schnitz | segment
die Schale | skin
der Kern | stone
roh | raw
frisch | fresh
verfault | rotten
reif | ripe
unreif | unripe
kernlos | seedless
hacken | to chop
würfeln | to dice
raspeln | to grate
entsaften | to juice
schälen | to peel

der Apfel | apple
die Aprikose | apricot
die Banane | banana
die Brombeere | blackberry
die schwarze Johannisbeere | blackcurrant
die Blaubeere | blueberry
die Kirsche | cherry
die Stachelbeere | gooseberry
die Weintraube | grape
die Grapefruit | grapefruit
die Kiwi | kiwi fruit
die Zitrone | lemon
die Mango | mango
die Melone | melon
die Orange | orange
die Passionsfrucht | passion fruit
der Pfirsich | peach
die Birne | pear
die Ananas | pineapple
die Pflaume | plum
die Himbeere | raspberry
die rote Johannisbeere | redcurrant
die Erdbeere | strawberry
die Wassermelone | watermelon

die Artischocke | artichoke
der Spargel | asparagus
die Aubergine | aubergine
die Rote Beete | beetroot
der Brokkoli | broccoli
der Rosenkohl | Brussels sprout
der Kohl | cabbage
die Karotte | carrot
der Blumenkohl | cauliflower
der Sellerie | celery
der Chili | chilli
die Zucchini | courgette
die Gurke | cucumber
der Knoblauch | garlic
die grünen Bohnen; fpl | green beans
der Lauch | leek
der Blattsalat | lettuce
der Pilz | mushroom
die Zwiebel | onion
die Erbsen | peas
die Kartoffel | potato
der rote Paprika | red pepper
der Spinat | spinach
die Tomate | tomato

		das fischgeschäft | fishmonger's
das fischgeschäft | fishmonger's

der Fischhändler / die Fischhändlerin | fishmonger
die Gräte | (fish)bone
das Filet | fillet
der Rogen | roe
die Schuppen; fpl | scales
das Schalentier | shellfish
Schale | shell
Süßwasser- | freshwater
Meereswasser- | saltwater
gezüchtet | farmed
wild | wild
gesalzen | salted
geräuchert | smoked
entgrätet | deboned
filetiert | filleted

die Sardelle | anchovy
der Kabeljau | cod
der Aal | eel
der Schellfisch | haddock
der Hering | herring
die Seezunge | lemon sole
die Makrele | mackerel
der Seeteufel | monkfish
der Lachs | salmon
die Sardine | sardine
die Brasse | sea bream
der Rochen | skate
die Forelle | trout
der Thunfisch | tuna
der Zander | zander

die Venusmuschel | clam
die Krabbe | crab
die Languste | crayfish
der Hummer | lobster
die Miesmuschel | mussel
der Kraken | octopus
die Auster | oyster
die Garnele | prawn
die Jakobsmuschel | scallop
der Seeigel | sea urchin
die Garnele | shrimp
der Tintenfisch | squid

		die metzgerei | butcher's
die metzgerei | butcher's

der Metzger / die Metzgerin | butcher
das Fleisch | meat
das rote / weiße Fleisch | red / white meat
die Wurstwaren; fpl | cold meats
das Kalbfleisch | veal
das Rindfleisch | beef
das Rehfleisch | venison
das Wild | game
die Ente | duck
die Gans | goose
das Lammfleisch | lamb
das Putenfleisch | turkey
das Schweinefleisch | pork
die Innereien | offal
das Bratenstück | joint
das Würstchen | frankfurter
die Pastete | pâté
bio | organic
roh | raw
gebraten | cooked
der Speck | bacon
der Hamburger | beefburger
die Bratwurst | bratwurst
das Hähnchen | chicken
das Kotelett | chop
der Schinken | ham
der Leberkäse | meatloaf
das Hackfleisch | mince
die Rippchen; ntpl | ribs
die Wurst | sausage
das Schnitzel | schnitzel
das Steak | steak

		die bäckerei und die konditorei | bakery and patisserie
die bäckerei und die konditorei | bakery and patisserie

der Bäcker / die Bäckerin | baker
das Brot | bread
das Vollkornbrot | wholemeal bread
der Brotlaib | loaf
das Baguette | baguette
das Croissant | croissant
das Stück | slice
die Kruste | crust
der Teig | dough
das Mehl | flour
glutenfrei | gluten-free
backen | to bake
der Apfelstrudel | apple strudel
die Schwarzwälder Kirschtorte | black forest gateau
die Brötchen; ntpl | bread rolls
der Käsekuchen | cheesecake
das Plundergebäck | Danish pastry
der Berliner | doughnut
die Obsttorte | fruit tart
der Lebkuchen | lebkuchen
das Marzipan | marzipan
die Pfannkuchen; mpl | pancakes
die Brezel | pretzel
der Stollen | stollen

		eier und milchprodukte | eggs and dairy products
eier und milchprodukte | eggs and dairy products

das Eiweiß | egg white
das Eigelb | egg yolk
der Doppelrahm | double cream
die saure Sahne | sour cream
die Margarine | margarine
die H-Milch | UHT milk
die pasteurisierte Milch | pasteurized milk
die Rohmilch | unpasteurized milk
die Vollmilch | whole milk
die Magermilch | skimmed milk
die Halbfettmilch | semi-skimmed milk
aus Käfighaltung | caged
aus Freilandhaltung | free-range
milchfrei | dairy-free
die Butter | butter
die Sahne | cream
das Ei | egg
die Milch | milk
die Sojamilch | soymilk
der Joghurt | yoghurt

		der käse | cheese
der käse | cheese

der Blauschimmelkäse | blue cheese
der Frischkäse | cream cheese
der Quark | curd cheese
der Appenzeller | Appenzeller
der Camembert | Camembert
der Emmental | Emmenthal
der Ziegenkäse | goat's cheese
der Mozzarella | mozzarella
der Parmesan | parmesan
der Roquefort | Roquefort
der Räucherkäse | smoked cheese
der Tilsiter | Tilsit cheese

		die apotheke | pharmacy
die apotheke | pharmacy

der Apotheker / die Apothekerin | pharmacist
das Rezept | prescription
die Erkältung | cold
der Durchfall | diarrhoea
der Heuschnupfen | hay fever
die Kopfschmerzen; mpl | headache
die Halsschmerzen; mpl | sore throat
die Magenschmerzen; mpl | stomachache
das Antihistaminikum | antihistamine
das Antiseptikum | antiseptic
das abschwellende Mittel | decongestant
das Schmerzmittel | painkiller
die Hand-Waschlotion | handwash

die antiseptische Salbe | antiseptic cream
der Verband | bandage
die Kapsel | capsule
das Kondom | condom
der Hustensaft | cough mixture
die Tropfen; mpl | drops
das Insektenschutzmittel | insect repellent
die Pastille | lozenge
die Medizin | medicine
das Pflaster | plaster
die Sonnencreme | suntan lotion
die Tablette | tablet / pill

die Pflegespülung | conditioner
die Zahnseide | dental floss
das Mundwasser | mouthwash
der Rasierer | razor
die Damenbinde | sanitary towel
das Shampoo | shampoo
der Rasierschaum | shaving foam
das Duschgel | shower gel
die Seife | soap
der Tampon | tampon
die Zahnbürste | toothbrush
die Zahnpasta | toothpaste

das Rouge | blusher
der Kamm | comb
der Eyeliner | eyeliner
der Lidschatten | eyeshadow
die Grundlage | foundation
die Haarbürste | hairbrush
das Haarspray | hairspray
der Lippenbalsam | lip balm
der Lippenstift | lipstick
die Mascara | mascara
der Nagellack | nail varnish
der Puder | powder

		für das baby | baby goods
für das baby | baby goods

die Kolik | colic
die Wegwerfwindel | disposable nappy
das Schaumbad | bubble bath
die Windeldermatitis | nappy rash
zahnen | to be teething
stillen | to breast-feed

der Babyschlafanzug | babygro / sleepsuit
das Lätzchen | bib
die Babyschühchen; ntpl | bootees
die Fausthandschuhe; mpl | mittens
der Schneeanzug | snowsuit
der Body | vest

die Babynahrung | baby food
die Babylotion | baby lotion
die Babyflasche | baby's bottle
die Wickeltasche | changing bag
das Wattestäbchen | cotton bud
die Watte | cotton wool
die Formel | formula milk
die Windel | nappy
die Windelcreme | nappy cream
der Zwieback | rusk
der Körperpuder | talcum powder
die Feuchttücher; ntpl | wet wipes

die Babywanne | baby bath
die Babyschale | baby seat
das Lauflerngerät | baby walker
das Kinderbett | cot
der Schnuller | dummy
der Hochstuhl | highchair
das Mobile | mobile
der Moseskorb | Moses basket
der Kinderwagen | pram
der Sportwagen | pushchair
der Beißring | teething ring
das Reisebett | travel cot

		der zeitungsladen | newsagent
der zeitungsladen | newsagent

die großformatige Zeitung | broadsheet
der Kiosk | kiosk
die Schreibwaren; fpl | stationery
die Boulevardzeitung | tabloid
der Tabakwarenladen | tobacconist
der Verkäufer / die Verkäuferin | vendor
täglich | daily
wöchentlich | weekly

das Buch | book
die Zigarre | cigar
die Zigarette | cigarette
das Comicheft | comic book
die Süßigkeiten; fpl | confectionery
der Briefumschlag | envelope
die Grußkarte | greetings card
die Zeitschrift | magazine
die Landkarte | map
die Zeitung | newspaper
das Notizbuch | notebook
der Kugelschreiber | pen
der Bleistift | pencil
die Postkarte | postcard
das Rätselbuch | puzzle book
das Rubbellos | scratch card
die Briefmarke | stamp
der Tabak | tobacco

		das kaufhaus | department store
das kaufhaus | department store

die Marke | brand
die Theke | counter
die Rolltreppe | escalator
der Fahrstuhl | lift
die Toilette | toilets
die Etage | floor
die Abteilung | department
die Herrenbekleidung | menswear
die Damenbekleidung | womenswear
die Sportkleidung | sportswear
die Badebekleidung | swimwear
der Ausverkauf | sale
verkauft werden | to be on sale
im (Sonder)angebot sein | to be in the sale
die Modeaccessoires; ntpl | accessories
die Kosmetika | cosmetics
die Mode | fashion
die Lebensmittel; ntpl | food and drink
die Schuhe; mpl | footwear
die Möbel; ntpl | furniture
die Küchengeräte; ntpl | kitchenware
die Lederwaren; fpl | leather goods
die Beleuchtung | lighting
die Damenwäsche | lingerie
die Wohntextilien; fpl | soft furnishings
das Spielzeug | toys

		kleidung und schuhe | clothing and footwear
kleidung und schuhe | clothing and footwear

die Umkleidekabine | fitting room
die Kleidung | clothes / clothing
die Schuhe; mpl | shoes / footwear
die Unterwäsche | underwear
der (Regen)schirm | umbrella
der Schmuck | jewellery
das Parfüm | scent
lässig | casual
schick | smart
die Wolle | wool
die Baumwolle | cotton
das Leder | leather
die Seide | silk
die Größe | size
kleine Größe | petite
Übergrößen- | plus-size
anprobieren | to try on
passen | to fit

der Bikini | bikini
die Bluse | blouse
die Boxershorts pl | boxer shorts
der Büstenhalter | bra
die Strickjacke | cardigan
der Mantel | coat
das Kleid | dress
der Bademantel | dressing gown
die Latzhose | dungarees
die Jacke | jacket
die Jeans pl | jeans
die Jogginghose | jogging bottoms
der Pullover | jumper
die Leggings pl | leggings
die Unterhose | pants
der Schlafanzug | pyjamas
das Hemd | shirt
die Shorts pl | shorts
der Rock | skirt
die Socken; fpl | socks
das Kostüm | suit
das Sweatshirt | sweatshirt
der Badeanzug | swimsuit
der Dreiteiler | three-piece suit
die Krawatte | tie
die Strumpfhose | tights
die Hose | trousers
das T-Shirt | T-shirt
die Weste | waistcoat
die Regenjacke | waterproof jacket

die Baseballmütze | baseball cap
der Gürtel | belt
das Armband | bracelet
die Hosenträger; mpl | braces
die Ohrringe; mpl | earrings
die Handschuhe; mpl | gloves
die Handtasche | handbag
die Halskette | necklace
der Geldbeutel | purse
der Schal | scarf
die Brieftasche | wallet
die Wollmütze | woolly hat

die Stiefel; mpl | boots
die Pumps; mpl | court shoes
die Stöckelschuhe; mpl | high heels
die Schnürschuhe; mpl | lace-up shoes
die Strandschuhe; mpl | plimsolls
die Sandalen; fpl | sandals
die Pantoffeln; fpl | slippers
die Sportschuhe; mpl | trainers
die Gummistiefel; mpl | Wellington boots

		der baumarkt | diy store
der baumarkt | diy store

die Elektrizität | electricity
die Tischlerei | joinery
das Heimwerken, das DIY | home improvements
das Streichen | painting
das Tapezieren | decorating
die Klempnerarbeiten; fpl | plumbing
das Werkzeug | tool
das Elektrowerkzeug | power tool
der Werkzeugkasten | toolbox
heimwerken | to do DIY
der Meißel | chisel
die Bohrmaschine | electric drill
der Hammer | hammer
die Nägel; mpl | nails
die Muttern und Bolzen pl | nuts and bolts
die Farbe | paint
der Pinsel | paintbrush
der Farbroller | paint roller
die Zange | pliers
die Säge | saw
der Schraubenzieher | screwdriver
die Schrauben; fpl | screws
der Schraubenschlüssel | spanner
die Wasserwaage | spirit level
die Trittleiter | stepladder
die Fliesen; fpl | tiles
die Tapete | wallpaper
der Schraubenschlüssel | wrench

		andere läden | other shops
andere läden | other shops
die Antiquitätenhandlung | antique shop
der Herrenfriseur | barber's
der Kosmetiksalon | beauty salon
der Buchmacher | bookmaker's
der Buchladen | bookshop
die Boutique | boutique
das Autohaus | car showroom
der Elektrofachmarkt | electrical retailer
das Immobilienbüro | estate agency
der Blumenladen | florist's
der Möbelmarkt | furniture store
das Gartencenter | garden centre
der Frisör | hairdresser's
das Reformhaus | health food shop
das Juweliergeschäft | jeweller's
der Musikladen | music shop
die Wein- und Spirituosen-handlung | off-licence
der Optiker | optician's
die Tierhandlung | pet shop
der Handy-Shop | phone shop
das Schuhgeschäft | shoe shop
das Shoppingcenter | shopping mall
das Spielwarengeschäft | toyshop
das Reisebüro | travel agency

	der alltag | day-to-day
der alltag | day-to-day

der Milchkaffee | coffee with milk
die Tasse | cup
der Henkel | handle
die Untertasse | saucer

		das wesentliche | the basics
aufwachen | to wake up
sich anziehen | to get dressed
ankommen | to arrive
weggehen | to leave
studieren | to study
arbeiten | to work
sich mit Freunden treffen | to meet friends
nach Hause gehen | to go home
ins Bett gehen | to go to bed

		das frühstück | breakfast
das frühstück | breakfast

die Frühstückstheke | breakfast bar
das Butterbrot | bread and butter
das Marmeladenbrot | bread and jam
der Quark | quark
die Spiegeleier; ntpl | fried eggs
die verlorene Eier; ntpl | poached eggs
aufstreichen | to spread
frühstücken | to have breakfast
das Frühstück überspringen | to skip breakfast
die gekochten Eier; ntpl | boiled eggs
die Brötchen; ntpl | bread rolls
die Frühstückscerealien pl | cereal
der Kaffee | coffee
der Milchkaffee | coffee with milk
die Wurst und der Käse | cold meats and cheese
das Croissant | croissant
der Honig | honey
der Kakao | hot chocolate
die Marmelade | jam
der Orangensaft | orange juice
das Roggenbrot | rye bread
das Müsli | muesli
die Rühreier; ntpl | scrambled eggs
der Tee | tea

		die hauptmahlzeiten | main meals
die hauptmahlzeiten | main meals

das Essen | food
das Getränk | drink
das Mittagessen | lunch
das Abendessen | dinner
die Gänge; mpl | courses
das Rezept | recipe
der Aperitif | aperitif
der Digestif | after-dinner drink
essen / trinken | to eat / drink
zu Mittag essen | to have lunch
speisen | to have dinner
zum Essen ausgehen | to eat out

der Spargel mit Schinken | asparagus wrapped in ham
der Aufschnitt | cold meats
der grüne Salat | green salad
der gemischte Salat | mixed salad
das Omelett | omelette
der Zwiebelkuchen | onion tart
die Pastete | pâté
der Räucherlachs | smoked salmon
die Suppe | soup

die Pommes; ntpl | chips
der Gurkensalat | cucumber salad
die Bratkartoffeln ntp | fried potatoes
die Klöße; mpl | German dumplings
der Auflauf | gratin
der Kartoffelbrei | mash
die Nudeln; fpl | noodles
die Nudeln; fpl | pasta
die Kartoffeln; fpl | potatoes
die Kartoffelpuffer; mpl | potato fritters
der Reis | rice
das Gemüse | vegetables

die Rinderrouladen; fpl | beef olives
das Hühnerfrikassee | chicken fricassee
der Brathering | fried and marinated herring
das Kassler mit Sauerkraut | gammon with sauerkraut
die Gulaschsuppe | goulash soup
die Frikadellen; fpl | meatballs
die Fritattensuppe | pancake soup
die Erbsensuppe | pea soup
das Eisbein auf Sauerkraut | pork knuckle with sauerkraut
der Sauerbraten | pot roast
die Maultaschen; fpl | ravioli
die Kohlrouladen; fpl | stuffed cabbage leaves
das Schnitzel | schnitzel

der Apfelstrudel | apple strudel
der Apfelkuchen | apple tart
der Pudding | blancmange
der Schokoladenkuchen | chocolate cake
die Obsttorte | fruit tart
das Eis | ice cream
die rote Grütze | red fruit compote
der Kaiserschmarrn | shredded pancake
die Weinschaumcreme | syllabub

		auswärts essen | eating out
auswärts essen | eating out

die Tageskarte | set menu
die Tagesgerichte; ntpl | daily specials
die Bedienung | service charge
das Trinkgeld | tip
der Weinkellner / die Weinkellnerin | wine waiter
der Barkeeper / die Bardame | barman / barmaid
vegetarisch | vegetarian
veganisch | vegan
glutenfrei | gluten-free
milchfrei | dairy-free
einen Tisch reservieren | to reserve a table
bestellen | to order
die Rechnung verlangen | to ask for the bill
bedient werden | to be served
die Bar | bar
die Rechnung | bill
der Brotkorb | bread basket
der Stuhl | chair
das Sektglas | champagne flute
das Käsemesser | cheese knife
das Fischmesser | fish knife
der Krug Wasser | jug of water
die Speisekarte | menu
die Serviette | napkin
das Salz und der Pfeffer | salt and pepper
das Steakmesser | steak knife
der Tisch | table
die Tischdecke | tablecloth
die Zahnstocher; mpl | toothpicks
der Essig und das Öl | vinegar and oil
der Kellner / die Kellnerin | waiter / waitress
das Weinglas | wine glass

		das fastfood | fast food
das fastfood | fast food
die Fastfood-Kette | fast-food chain
der Schnellimbiss | food stall
das Streetfood | street food
der Verkäufer / die Verkäuferin | vendor
das Drive-In | drive-thru
zum Mitnehmen | an order to go / a takeaway
die Lieferkosten pl | delivery charge
der Lieferant / die Lieferantin | delivery man / woman
eine Bestellung telefonisch aufgeben | to phone in an order
bestellen | to place an order
die Bestellung abholen | to collect an order
die gefüllte Kartoffel | baked potato
die Bratwurst | bratwurst
der Hamburger | burger
die Pommes frites; ntpl | fries
der Kebab | kebab
das Omelett | omelette
die Pizza | pizza
die Brezel | pretzel
das Sandwich | sandwich
die Currywurst | sausage with curry sauce
die Sushis; ntpl | sushi
der Wrap | wrap

		die kommunikation und die informationstechnologie | communication and it
die kommunikation und die informationstechnologie | communication and it

der Beitrag | post
die sozialen Netzwerke; ntpl | social media
die E-Mail | email
die E-Mail-Adresse | email address
der Link | link
das Internet | internet
das WLAN | WiFi
die Website | website
das Icon | icon
die Maus | mouse
das Mauspad | mouse mat
die Tastatur | keyboard
die App | app
die Daten; ntpl | data
das Handy | mobile phone
das Festnetz | landline
der Anruf | phone call
die SMS | text message
das Handy-Signal | phone signal
die Voicemail | voice mail
der Touchscreen | touchscreen
der Bildschirm | monitor
die Taste | button
der Akku | battery
das Kabel | cable
anrufen | to make a phone call
eine SMS / E-Mail schicken | to send a text / an email
posten | to post (online)
herunterladen / hochladen | to download / upload
anklicken | to click on
das Handy aufladen | to charge your phone
einschalten / ausschalten | to switch on / off
das Ladegerät | charger
der Computer | computer
die SIM-Karte | SIM card
das Smartphone | smartphone
das Tablet | tablet
der WLAN-Router | wireless router

		die bildung | education
die bildung | education

die Vorschule | nursery school
die Grundschule | primary school
die Realschule | secondary school
die Hochschule | college
die Universität | university
der Schulleiter / die Schulleiterin | headteacher
der Lehrer / die Lehrerin | teacher
der Schüler / die Schülerin | pupil
der Hausmeister / die Hausmeisterin | janitor
das Klassenzimmer | classroom
der Stundenplan | timetable
die Unterrichtsstunde | lesson
der Vortrag | lecture
das Tutorial | tutorial
die Hausaufgaben; fpl | homework
die Aufgabe | assignment
die Prüfung | exam
der Abschluss | degree
der Student / die Studentin | undergraduate
der Graduierte / die Graduierte | postgraduate
die Kantine | canteen
die Aula | assembly hall
das Spielfeld | playing field
der Schulhof | playground
die Studentenwohnheime; ntpl | halls of residence
das Studentenwerk | student union
der Studentenausweis | student card
lernen | to learn
lesen | to read
schreiben | to write
lehren | to teach
überarbeiten | to revise
eine Prüfung ablegen | to sit an exam
den Abschluss machen | to graduate
studieren | to study

die Farbstifte; mpl | colouring pencils
der Radierer | eraser
das Heft | exercise book
das Papier | paper
der Kugelschreiber | pen
der Bleistift | pencil
die Federmappe | pencil case
das Lineal | ruler
die Schultasche | schoolbag
der Anspitzer | sharpener
das Lehrbuch | textbook
die Weißwandtafel | whiteboard

die Cafeteria | cafeteria
der Campus | campus
der Hörsaal | lecture hall
der Dozent / die Dozentin | lecturer
die Bibliothek | library
der Student / die Studentin | student

		im büro | the office
im büro | the office

der Chef / die Chefin | manager
die Mitarbeiter; mpl | staff
der Kunde / die Kundin | client
der Lieferant / die Lieferantin | supplier
der Kollege / die Kollegin | colleague
die Personalabteilung | human resources
die Buchhaltung | accounts
die Zahlen; fpl | figures
die Tabellenkalkulation | spreadsheet
der Vortrag | presentation
der Bericht | report
die Sitzung | meeting
das Konferenzgespräch | conference call
die Videokonferenz | video conference
die Tintenpatrone | ink cartridge
der Posteingang | inbox
die Datei | file
der Anhang | attachment
das Upgrade | upgrade
der Benutzername | username
das Passwort | password
Maschine schreiben | to type
einloggen / ausloggen | to log on / off
einen Vortrag halten | to give a presentation
eine Sitzung einberufen | to hold a meeting
der Taschenrechner | calculator
der Schreibtisch | desk
die Schreibtischlampe | desk lamp
der Aktenschrank | filing cabinet
die Mappe | folder
der Locher | hole punch
die Ablage für Eingänge / Ausgänge | in / out tray
der Laptop | laptop
der Notizblock | notepad
die Heftklammer | paper clip
das Fotokopiergerät | photocopier
der Drucker | printer
das Ringbuch | ring binder
der Scanner | scanner
die Schere | scissors
der Hefter | stapler
die Post-it-Notizen; fpl | sticky notes
das Klebeband | sticky tape
der Drehstuhl | swivel chair
das Telefon | telephone
der USB-Stick | USB stick

		auf der bank | the bank
auf der bank | the bank

die Zweigstelle | branch
der Kassierer / die Kassierin | cashier
das Online-Banking | online banking
das Bankkonto | bank account
das Girokonto | current account
das Sparkonto | savings account
die Kontonummer | account number
der Kontoauszug | bank statement
der Kontostand | bank balance
die Kontoüberziehung | overdraft
die Überweisung | bank transfer
das Scheckheft | chequebook
die Währung | currency
das Darlehen | loan
die Hypothek | mortgage
die Zinsen pl | interest
einen Kredit aufnehmen | to borrow
zurückzahlen | to repay
abheben | to withdraw
Geld einzahlen | to make a deposit
Geld wechseln | to change money
der Geldautomat | ATM
die Banknoten; fpl | banknotes
die Wechselstube | bureau de change
die Bankkarte / Kreditkarte | debit / credit card
der Wechselkurs | exchange rate
der Safe | safety deposit box

		auf der post | the post office
auf der post | the post office

die Adresse | address
das Postfahrzeug | postal van
der Kurier | courier
die Post | mail
die Luftpost | airmail
prioritär | first-class
Standard | second-class
einwerfen | to post
schicken | to send
Post bekommen | to receive mail
ein Paket zurückschicken | to return a package
die Schachtel | box
der Briefumschlag | envelope
der Brief | letter
das Paket | package
die Luftpolstertasche | padded envelope
der Postangestellte / die Postangestellte | postal worker
der Briefkasten | postbox
die Postkarte | postcard
die Briefmarke | stamp

		in der stadt | in town
in der stadt | in town

das Café | café
die Kathedrale | cathedral
die Kirche | church
das Kongresszentrum | conference centre
das Gerichtsgebäude | courthouse
die Feuerwache | fire station
der Springbrunnen | fountain
das Krankenhaus | hospital
das Hotel | hotel
der Waschsalon | laundrette
die Bibliothek | library
die Moschee | mosque
das Bürogebäude | office block
der Park | park
der Spielplatz | playground
die Polizeiwache | police station
die Synagoge | synagogue
das Rathaus | town hall

	in der freizeit | leisure
in der freizeit | leisure

das Zelt | tent
das Überzelt | flysheet
der Zeltboden | groundsheet
die Zeltleine | guy rope
der Zeltpflock | tent peg

		das wesentliche | the basics

der Urlaub | holiday
die Freizeit | spare time
die Aktivität | activity
das Hobby | hobby / pastime
sich für etwas interessierien | to be interested in something
etwas gern tun | to be keen on doing something
die Zeit vertreiben | to pass the time
sich entspannen | to relax
genießen | to enjoy
sich langweilen | to be bored
das Kochen | cooking
das Heimwerken | DIY
Videospiele spielen | gaming
die Gartenarbeit | gardening
das Jogging | jogging
Musik hören | listening to music
das Lesen | reading
das Einkaufen | shopping
der Sport | sports
das Reisen | travelling
das Laufen | walking
fernsehen / Filme sehen | watching TV / films

		besichtigungen | sightseeing
besichtigungen | sightseeing
der Tourist / die Touristin | tourist
die Touristenattraktion | tourist attraction
der Ausflug | excursion
das Naturschutzgebiet | nature reserve
die historische Stätte | historic site
die Rundfahrt | guided tour
der Audioguide | audio guide
besichtigen | to visit
sehen | to see
buchen | to book
die Kunstgalerie | art gallery
die Kamera | camera
das Schloss | castle
die Kathedrale | cathedral
der Stadtplan | city map
der Garten | gardens
der Reiseführer | guidebook
das Denkmal | monument
das Museum | museum
der Sightseeing-Bus | sightseeing bus
der Reiseführer / die Reiseführerin | tour guide
das Fremdenverkehrsbüro | tourist office

		ausgehen | evenings out
ausgehen | evenings out
ein Glas | a drink
das Nachtleben | nightlife
die Party | party
die Vorführung | show
das (Theater)stück | play
der Film | film
die Festspiele | festival
die Kasse | box office
Kontakte knüpfen | to socialize
zu essen / zu trinken bestellen | to order food / drinks
sich eine Vorführung ansehen | to see a show
sich einen Film ansehen | to watch a film
tanzen gehen | to go dancing
sich amüsieren | to enjoy oneself
das Ballett | ballet
die Bar | bar
der Karneval | carnival
das Kasino | casino
das Kino | cinema
die Comedy-Show | comedy show
das Konzert | concert
der Jahrmarkt | funfair
das Musical | musical
der Nachtclub | nightclub
die Oper | opera
das Restaurant | restaurant
das Theater | theatre

		im hotel | hotel
im hotel | hotel

die Frühstückspension | bed and breakfast
die Vollpension | full board
die Halbpension | half board
"Zimmer frei" | "vacancies"
der Zimmerservice | room service
der Weckruf | wake-up call
die Zimmernummer | room number
pro Person pro Nacht | per person per night
einchecken | to check in
abreisen | to check out
Zimmerservice bestellen | to order room service
der Korridor | corridor
das "Bitte nicht stören"-Schild | "do not disturb" sign
das Doppelzimmer | double room
die Schlüsselkarte | key card
die Minibar | minibar
der Gepäckträger / die Gepäckträgerin | porter
der Empfangsbereich | reception
der Empfangschef / die Empfangschefin | receptionist
der Tresor | safe
das Einzelzimmer | single room
die Toilettenartikel; mpl | toiletries
das Zweibettzimmer | twin room

		campen | camping
campen | camping

der Campingplatz | campsite
der Platz | pitch
der Stromanschluss | electricity hook-up
der Sanitärblock | toilet / shower block
der Camper / die Camperin | camper
"Zelten verboten" | "no camping"
zelten | to camp
ein Zelt aufschlagen / abbrechen | to pitch / take down a tent
die Luftmatratze | air bed
der Grill | barbecue
der Campingkocher | camping stove
der Wohnwagen | caravan
die Kühlbox | cool box
der Campingstuhl | fold-up chair
die Streichhölzer; ntpl | matches
der Camper | motorhome
die Picknick-Decke | picnic blanket
der Schlafsack | sleeping bag
das Zelt | tent
die Taschenlampe | torch

		am strand | the beach
am strand | the beach

"Baden verboten." | "No swimming."
das Badegebiet | bathing zone
die Sonnenbräune | suntan
in der Sonne liegen | to sunbathe
schwimmen | to swim

der Sand | sand
das Meer | sea
die Wellen; fpl | waves
der Sonnenschirm | parasol
die Sonnenliege | sunbed
das Strandtuch | beach towel

der Wasserball | beach ball
das Strandhäuschen | beach hut
der Bikini | bikini
der Eimer und die Schaufel | bucket and spade
der Liegestuhl | deckchair
die Flip-Flops; mpl | flip-flops
die Flossen; fpl | flippers
die Promenade | promenade
die Sandburg | sandcastle
die Muscheln; fpl | seashells
der Seetang | seaweed
der Schnorchel | snorkel
die Sonnenbrille | sunglasses
der Sonnenhut | sunhat
die Sonnencreme | suntan lotion
die Badehose | swimming trunks
der Badeanzug | swimsuit
der Windschutz | windbreak

		musik | music
musik | music

der DJ | DJ
die CD | CD
die Schallplatte | vinyl record
das Mikrofon | microphone
das Lied | song
das Album | album
der SingerSongwriter / die SingerSongwriterin | singer-songwriter
die Band | band
die Livemusik | live music
der Gig | gig
der Pop | pop
die Folkmusik | folk music
der Rock | rock
der Hip-Hop | hip-hop
musik | music
der Rap | rap
klassisch | classical
ein Instrument spielen | to play an instrument
singen | to sing
Musik hören | to listen to music
auf Konzerte gehen | to go to gigs

der Bluetooth®-Lautsprecher | Bluetooth® speaker
die Ohrhörer; mpl | earphones
die Kopfhörer pl | headphones
die Soundbar | soundbar
die Lautsprecher; mpl | speakers
der Plattenspieler | turntable

das Akkordeon | accordion
die Akustikgitarre | acoustic guitar
die große Trommel | bass drum
der E-Bass | bass guitar
das Cello | cello
die Klarinette | clarinet
das Becken | cymbals
der Kontrabass | double bass
die E-Gitarre | electric guitar
die Flöte | flute
die Harfe | harp
das Keyboard | keyboard
die Mundharmonika | mouth organ
das Klavier | piano
das Saxophon | saxophone
die kleine Trommel | snare drum
die Posaune | trombone
die Trompete | trumpet
die Tuba | tuba
die Geige | violin
das Xylophon | xylophone

der Chor | choir
der Dirigent / die Dirigentin | conductor
der Musiker / die Musikerin | musician
das Orchester | orchestra
die Noten; fpl | sheet music
der Sänger / die Sängerin | singer

		fotografie | photography
fotografie | photography
das Foto | photo
der Fotograf / die Fotografin | photographer
das Selfie | selfie
der Selfie-Stick | selfie stick
ein Foto / Selfie machen | to take a photo / selfie
heranzoomen | to zoom in
das Objektiv | camera lens
die Kompaktkamera | compact camera
die Drohne | drone
die DSLR-Kamera | DSLR camera
die SD-Speicherkarte | SD card
das Stativ | tripod

		spiele | games
spiele | games

der Spieler / die Spielerin | player
das Versteckspiel | hide and seek
das Kreuzworträtsel | crossword
die Patience | solitaire
das Poker | poker
das Blatt | hand (in cards)
die Spielekonsole | games console
das Videospiel | video game
spielen | to play
würfeln | to roll the dice
gewinnen | to win
verlieren | to lose
das Backgammon | backgammon
das Brettspiel | board game
das Bowling | bowling
die Karten; fpl | cards
das Schachspiel | chess
die Spielsteine; mpl | counters
die Darts | darts
der Würfel | dice
das Dominospiel | dominoes
das Damespiel | draughts
das Puzzle | jigsaw puzzle
das Kegelspiel | skittles

		kunsthandwerk | arts and crafts
kunsthandwerk | arts and crafts

das Kunsthandwerk | handicrafts
der Kunsthandwerksmarkt | craft fair
der Künstler / die Künstlerin | artist
der Amateur / die Amateurin | amateur
der Schneider / die Schneiderin | dressmaker
malen | to paint
skizzieren | to sketch
nähen | to sew
stricken | to knit
kreativ sein | to be creative

die Stickerei | embroidery
die Schmuckherstellung | jewellery-making
der Modellbau | model-making
die Papierbastelei | papercrafts
die Töpferei | pottery
die Holzarbeit | woodwork

die Leinwand | canvas
die Staffelei | easel
die Tinte | ink
die Ölfarbe | oil paint
der Pinsel | paintbrush
die Palette | palette
das Papier | paper
die Pastellfarben; fpl | pastels
der Kugelschreiber | pen
der Bleistift | pencil
der Skizzenblock | sketchpad
die Wasserfarben; fpl | watercolours

der Knäuel | ball of wool
die Knöpfe; mpl | buttons
die Häkelnadel | crochet hook
der Stoff | fabric
die Stoffschere | fabric scissors
die Stricknadeln; fpl | knitting needles
die Nadel und der Faden | needle and thread
die Stecknadeln; fpl | pins
die Sicherheitsnadel | safety pin
der Nähkorb | sewing basket
die Nähmaschine | sewing machine
das Maßband | tape measure

	der sport | sport
der sport | sport

der Mittelkreis | centre circle

		das wesentliche | the basics

das Turnier | tournament
der Wettbewerb | competition
die Meisterschaft | league
der Meister / die Meisterin | champion
der Mannschaftskamerad / die Mannschaftskameradin | teammate
der Teilnehmer / die Teilnehmerin | competitor
der Trainer / die Trainerin | coach
der Cheftrainer / die Cheftrainerin | manager
das Spiel | match
die Punkte; mpl | points
trainieren | to coach
teilnehmen | to compete
Punkte erzielen | to score
gewinnen | to win
verlieren | to lose
unentschieden spielen | to draw
das Freizeitzentrum | leisure centre
die Medaille | medal
der Offizielle / die Offizielle | official
das Podium | podium
der Schiedsrichter / die Schiedsrichterin | referee
die Anzeigetafel | scoreboard
die Zuschauer; mpl | spectators
der Sportler / die Sportlerin | sportsperson
das Stadion | stadium
die Tribüne | stands
die Mannschaft | team
die Trophäe | trophy

		fitness | wellbeing
fitness | wellbeing

das Fitnessstudio | gym
der Fitnesstrainer / die Fitnesstrainerin | gym instructor
die Mitgliedschaft im Fitnessstudio | gym membership
der Personal Trainer | personal trainer
der Fitnesskurs | exercise class
das Pilates | Pilates
das Yoga | yoga
die Liegestütze; mpl | press-ups
die Sit-ups; mpl | sit-ups
das Gehen | walking
das Laufen | running
der Laufklub | running club
Sport treiben | to exercise
fit bleiben | to keep fit
laufen gehen | to go for a run
ins Fitnessstudio gehen | to go to the gym

der Umkleideraum | changing room
der Crosstrainer | cross trainer
die Hantel | dumbbell
der Heimtrainer | exercise bike
der Gymnastikball | gym ball
die Kettlebell | kettle bell
der Spind | locker
das Rudergerät | rowing machine
der Duschraum | showers
das Springseil | skipping rope
das Laufband | treadmill
die Hantelbank | weightlifting bench

		fußball | football
fußball | football

der Abwehrspieler / die Abwehrspielerin | defender
der Stürmer / die Stürmerin | striker
der Ersatzspieler / die Ersatzspielerin | substitute
der Anstoß | kick-off
die Halbzeit | half-time
die reguläre Spielzeit | full-time
die Verlängerung | extra time
die Nachspielzeit | injury time
der Freistoß | free kick
der Kopfball | header
die Abwehr | save
das Foul | foul
das Abseits | offside
der Strafstoß | penalty kick
der Strafraum | penalty box
Fußball spielen | to play football
kicken | to kick
angreifen | to tackle
den Ball abgeben | to pass the ball
ein Tor schießen | to score a goal
der Schiedrichterassistent / die Schiedrichterassistentin | assistant referee
der Fußball | football
die Fußballschuhe; mpl | football boots
das Fußballspiel | football match
das Spielfeld | football pitch
der Fußballspieler / die Fußballspielerin | football player
das Tor | goal
der Torwart / die Torwartin | goalkeeper
die Torwarthandschuhe; mpl | goalkeeper's gloves
die Schienbeinschützer; mpl | shin pads
die Pfeife | whistle
die gelbe / rote Karte | yellow / red card

		eishockey | ice hockey
eishockey | ice hockey

die blaue Linie | blue line
die Bande | boards
der Check | check
der Abschlag | face-off
die Eiszeit | ice time
das Penaltyschießen | penalty shot
das Drittel | period
das Powerplay | powerplay
Eishockey spielen | to play ice hockey
das Gitter | helmet cage
der Eishockeyspieler / die Eishockeyspielerin | ice hockey player
der Eishockeyschläger | ice hockey stick
die Fanghandschuhe; mpl | mitts
der Puck | puck
die Schlittschuhe; mpl | skates

		basketball | basketball
basketball | basketball
der Korbleger | layup
der Slam Dunk | slam dunk
der Freiwurf | free throw
Basketball spielen | to play basketball
fangen | to catch
werfen | to throw
dribbeln | to dribble
blockieren | to block
einen Spieler decken | to mark a player
der Korb | basket
der Basketball | basketball
das Basketballfeld | basketball court
das Basketball | basketball game
der Basketballspieler / die Basketballspielerin | basketball player
die Basketballschuhe; mpl | basketball shoes

		schlägersportarten | racket sports
schlägersportarten | racket sports

das Netz | net
das Ass | ace
der Aufschlag | serve
die Rückhand | backhand
die Vorhand | forehand
der Fehler | fault
der Ballwechsel | rally
Spiel, Satz und Sieg | game, set and match
das Einzel | singles
das Doppel | doubles
der topgesetzte Spieler / die topgesetzte Spielerin | top seed
Tennis spielen | to play tennis
Badminton spielen | to play badminton
schlagen | to hit
Aufschlag haben | to serve
den Break holen | to break someone's serve

das Badminton | badminton
der Badmintonschläger | badminton racket
der Federball | shuttlecock

das Squash | squash
der Squashball | squash ball
der Squashschläger | squash racket

der Balljunge / das Ballmädchen | ball boy / girl
der Linienrichter / die Linienrichterin | line judge
das Tennis | tennis
der Tennisball | tennis ball
der Tennisplatz | tennis court
der Tennisspieler / die Tennisspielerin | tennis player
der Tennisschläger | tennis racket
der Schiedsrichter / die Schiedsrichterin | umpire
der Hochstuhl | umpire's chair

		wassersport | water sports
wassersport | water sports

das Schwimmen | swimming
das Brustschwimmen | breaststroke
das Rückenschwimmen | backstroke
das Kraulen | front crawl
der Butterfly | butterfly
die Spur | lane
die Länge | length
der Schwimmunterricht | swimming lesson
der Schwimmer / die Schwimmerin | swimmer
der Taucher / die Taucherin | diver
das Tauchen | diving
das Angeln | angling
der Angler / die Anglerin | angler
der Surfer / die Surferin | surfer
schwimmen | to swim
tauchen | to dive
surfen | to surf
paddeln | to paddle
segeln | to sail
fischen | to fish

die Schwimmflügel; mpl | armbands
das Sprungbrett | diving board
die Flossen; fpl | flippers
die Schwimmbrille | goggles
der Rettungsschwimmer / die Rettungsschwimmerin | lifeguard
die Bademütze | swimming cap
das Schwimmbecken | swimming pool
die Badehose | swimming trunks
der Badeanzug | swimsuit

das Bodyboarding | bodyboarding
das Kanufahren | canoeing
der Jetski | jet ski
das Kajakfahren | kayaking
das Kitesurfen | kitesurfing
die Schwimmweste | lifejacket
das Paddel | paddle
das Paddleboarding | paddleboarding
das Sporttauchen | scuba diving
das Schnorcheln | snorkelling
das Surfbrett | surfboard
das Surfen | surfing
das Wasserskilaufen | waterskiing
der Neoprenanzug | wetsuit
das Windsurfen | windsurfing

		wintersport | winter sports
wintersport | winter sports

der Skifahrer / die Skifahrerin | skier
das Skigebiet | ski resort
der Skilift | ski lift
der Skilehrer / die Skilehrerin | ski instructor
die Bergwacht | mountain rescue service
der Verbandskasten | first-aid kit
der Schnee | snow
der Pulverschnee | powder
das Eis | ice
die Lawine | avalanche
die Lawinengefahr | avalanche risk
skifahren | to ski
freeriden | to ski off-piste
snowboarden | to snowboard
bergsteigen | to go mountain climbing
Schlitten fahren | to go sledging
Schlittschuh laufen | to go ice skating

der Karabiner | carabiner clip
die Steigeisen; ntpl | crampons
der Eispickel | ice axe
die Schlittschuhe; mpl | ice skates
das Seil | rope
der Schlitten | sledge

die Piste | piste
die Skihose | salopettes
die Skischuhe; mpl | ski boots
die Skihandschuhe; mpl | ski gloves
die Skibrille | ski goggles
der Skihelm | ski helmet
die Skijacke | ski jacket
die Skistöcke; mpl | ski poles
die Skier; mpl | skis
der Skianzug | ski suit
das Snowboard | snowboard
die Snowboardschuhe; mpl | snowboarding boots

		kampfsportarten | combat sports
kampfsportarten | combat sports

der Kampf | fight
der Boxer / die Boxerin | boxer
der Kämpfer / die Kämpferin | fighter
der Ringkämpfer / die Ringkämpferin | wrestler
der Gegner / die Gegnerin | opponent
das Federgewicht | featherweight
das Schwergewicht | heavyweight
der Punch | punch
der K.-o.-Schlag | knockout
boxen | to box
ringen | to wrestle
schlagen | to punch
kicken | to kick
zuschlagen | to strike
sparren | to spar
fechten | to fence
k.o. schlagen | to knock out

die Boxhandschuhe; mpl | boxing gloves
der Boxring | boxing ring
die Boxschuhe; mpl | boxing shoes
der Kopfschutz | headguard
der Zahnschutz | mouthguard
der Sandsack | punchbag

das Fechten | fencing
das Judo | judo
das Karate | karate
das Kickboxen | kickboxing
das Kung-Fu | kung fu
das Taekwondo | taekwondo
der Ringkampf | wrestling

		athletik | athletics
athletik | athletics

der Läufer / die Läuferin | runner
das Rennen | race
der Marathon | marathon
der Sprint | sprint
der Staffellauf | relay
die Spur | lane
der Durchgang | heat
das Finale | final
der Fehlstart | false start
die Startlinie | start line
die Ziellinie | finish line
der Dreisprung | triple jump
der Siebenkampf | heptathlon
der Zehnkampf | decathlon
der Startschuss | starter's gun
Leichtathletik betreiben | to do athletics
laufen | to run
Rennen laufen | to race
springen | to jump
werfen | to throw
der Leichtathlet / die Leichtathletin | athlete
der Diskus | discus
der Hochsprung | high jump
die Hürden; fpl | hurdles
der Speer | javelin
der Weitsprung | long jump
der Stabhochsprung | pole vault
die Rennbahn | running track
das Kugelstoßen | shot put
die Spikes; mpl | spikes
der Startblock | starting blocks
die Stoppuhr | stopwatch

		golf | golf

der Golfer / die Golferin | golfer
der Caddie | caddie
der Golfplatz | golf course
das Fairway | fairway
das Grün | green
der Sandbunker | bunker
das Loch | hole
das Klubhaus | clubhouse
das Hole-in-one | hole-in-one
golf | golf
das Birdie | birdie
über / unter Par | over / under par
Golf spielen | to play golf
abschlagen | to tee off
den Ball driven / putten | to drive / putt the ball
die Golftasche | golf bag
der Golfball | golf ball
der Golf-Buggy | golf buggy
der Golfklub | golf club
der Putter | putter
das Tee | tee

		andere sportarten | other sports
andere sportarten | other sports

der American Football | American football
das Bogenschießen | archery
das Baseball | baseball
das Klettern | climbing
das Fischen | fishing
die Gymnastik | gymnastics
der Handball | handball
das Hockey | hockey
das Pferderennen | horse racing
das Schlittschuhlaufen | ice skating
das Motorradrennen | motorcycle racing
das Autorennen | motor racing
der Korbball | netball
das Poolbillard | pool
das Rugby | rugby
das Schießen | shooting
das Springen | showjumping
das Skateboardfahren | skateboarding
das Snooker | snooker
das Tischtennis | table tennis
das Bahnradrennen | track cycling
der Volleyball | volleyball
der Wasserball | water polo
das Gewichtheben | weightlifting

	gesundheit | health
gesundheit | health

		das wesentliche | the basics

der Patient / die Patientin | patient
der Schmerz | pain
die Krankheit | illness
die geistige Gesundheit | mental health
das Krankenhaus | hospital
die Behandlung | treatment
die Krankenversicherung | health insurance
die Sozialversicherungskarte | social security card
gesund | healthy
sich erholen | to recover
sich um ... kümmern | to look after
behandeln | to treat
der Arzt / die Ärztin | doctor
der Apotheker / die Apothekerin | pharmacist
die Apotheke | pharmacy

		der körper | the body
der körper | the body

der Hals | throat
die Achsel | armpit
die Geschlechtsorgane; ntpl | genitals
die Brust | breast
die Wimper | eyelash
die Augenbraue | eyebrow
das Augenlid | eyelid
das Ohrläppchen | earlobe
die Nasenlöcher; ntpl | nostrils
die Lippen; fpl | lips
die Zunge | tongue
die Körperbehaarung | (body) hair
die Größe | height
das Gewicht | weight
der BMI | BMI
das Gehör | sense of hearing
das Sehvermögen | sense of sight
der Geruchssinn | sense of smell
der Geschmack | sense of taste
der Tastsinn | sense of touch
das Gleichgewicht | balance
sehen | to see
riechen | to smell
hören | to hear
berühren | to touch
schmecken | to taste
das Gleichgewicht verlieren | to lose one's balance

der Kopf | head
das Gesicht | face
der Hals | neck
der Arm | arm
der Brustkorb | chest
der Unterleib | abdomen
die Hand | hand
der Oberschenkel | thigh
das Bein | leg
das Knie | knee
das Schienbein | shin
der Fuß | foot

die Schulter | shoulder
der Ellbogen | elbow
der Rücken | back
die Hüfte | hip
das Gesäß | buttocks
die Wade | calf

das Haar | hair
die Stirn | forehead
das Auge | eye
das Ohr | ear
die Wange | cheek
die Nase | nose
der Mund | mouth
der Kiefer | jaw
das Kinn | chin

das Handgelenk | wrist
der Fingerknöchel | knuckle
der Fingernagel | fingernail
die Handfläche | palm
der Daumen | thumb
der Finger | finger

der große Zeh | big toe
der Zehennagel | toenail
der Zeh | toe
die Sohle | sole
die Ferse | heel
der Fußknöchel | ankle

		das skelett | the skeleton
das skelett | the skeleton

das Organ | organ
das Gehirn | brain
das Herz | heart
die Lunge | lung
die Leber | liver
der Magen | stomach
die Niere | kidney
die Därme; mpl | intestines
das Verdauungssystem | digestive system
das Atmungssystem | respiratory system
die Blase | bladder
das Blut | blood
das Gelenk | joint
der Knochen | bone
der Muskel | muscle
die Sehne | tendon
das Gewebe | tissue
das Band | ligament
die Zelle | cell
der Nerv | nerve
die Arterie | artery
die Vene | vein
der Sauerstoff | oxygen

der Schädel | skull
das Schlüsselbein | collarbone
die Wirbelsäule; fpl | vertebrae
der Humerus | humerus
das Brustbein | breastbone
die Rippen; fpl | ribs
die Wirbelsäule | spine
die Elle | ulna
der Radius | radius
das Becken | pelvis
der Femur | femur
die Kniescheibe | kneecap
das Wadenbein | fibula
das Schienbein | tibia

		die verletzung | injury
die verletzung | injury

der Sanitäter / die Sanitäterin | paramedic
der Unfall | accident
die Gehirnerschütterung | concussion
der Sturz | fall
die Verrenkung | dislocation
die Verstauchung | sprain
die Narbe | scar
das Schleudertrauma | whiplash
die Schwellung | swelling
die stabile Seitenlage | recovery position
die HLW | CPR
bewusstlos sein | to be unconscious
sich verletzen | to injure oneself
fallen | to fall
sich den Arm brechen | to break one's arm

die Blase | blister
der blaue Fleck | bruise
die Verbrennung | burn
die Schnittverletzung | cut
der Bruch | fracture
die Schürfwunde | graze
der Splitter | splinter
der Stich | sting
der Sonnenbrand | sunburn

der Verband | bandage
die Wundauflage | dressing
der Verbandskasten | first-aid kit
der Eisbeutel | ice pack
die Halskrause | neck brace
die Salbe | ointment
das Pflaster | plaster
die Schlinge | sling
die Pinzette | tweezers

		die krankheit | illness
die krankheit | illness

der Herzinfarkt | heart attack
der Schlaganfall | stroke
die Infektion | infection
die Ohrenentzündung | ear infection
das Virus | virus
die Erkältung | cold
die Grippe | flu
die Windpocken; fpl | chicken pox
das Magen­DarmProblem | stomach bug
die Lebensmittelvergiftung | food poisoning
das Erbrechen | vomiting
der Durchfall | diarrhoea
die Verstopfung | constipation
der Diabetes | diabetes
die Epilepsie | epilepsy
das Asthma | asthma
die Schwindligkeit | dizziness
der Inhalator | inhaler
die Regelschmerzen; mpl | period pain
hohen / niedrigen Blutdruck haben | to have high / low blood pressure
husten | to cough
niesen | to sneeze
sich übergeben | to vomit
in Ohnmacht fallen | to faint
das Husten | coughing
der Ohnmachtsanfall | fainting
das Fieber | fever
der Juckreiz | itching
die Übelkeit | nausea
der Ausschlag | rash
eine laufende Nase | runny nose
das Niesen | sneezing

		beim arzt | the doctor's surgery
beim arzt | the doctor's surgery

der Termin | appointment
die Klinik | clinic
die Untersuchung | examination
der Test | test
die Antibiotika; ntpl | antibiotics
die Pille | the pill
die Schlaftablette | sleeping pill
das Rezept | prescription
der Hausbesuch | home visit
die Impfung | vaccination
die Medikamente; ntpl | medication
appointment | to make an
vereinbaren | einen Termin
untersuchen | to examine
Medikamente einnehmen | to be on medication
das Blutdruckmessgerät | blood pressure monitor
der Untersuchungsraum | examination room
der Untersuchungstisch | examination table
der Hausarzt / die Hausärztin | the general practitioner
der Arzthelfer / die Arzthelferin | practice nurse
das Stethoskop | stethoscope
die Spritze | syringe
das Thermometer | thermometer
das Wartezimmer | waiting room

		beim zahnarzt | the dentist's surgery
beim zahnarzt | the dentist's surgery

der Backenzahn | molar
der Schneidezahn | incisor
der Eckzahn | canine
die Weisheitszähne; mpl | wisdom teeth
die Füllung | filling
die Krone | crown
die Wurzelbehandlung | root canal treatment
die Zahnschmerzen; mpl | toothache
der Abszess | abscess
das Zahnziehen | extraction
sich die Zähne putzen | to brush one's teeth
mit Zahnseide reinigen | to floss
die Zahnspange | braces
die Zahnseide | dental floss
der Zahnarzthelfer / die Zahnarzthelferin | dental nurse
der Zahnarzt / die Zahnärztin | dentist
der Zahnarztstuhl | dentist's chair
der Bohrer | dentist's drill
der Zahnersatz | dentures
das Zahnfleisch | gums
das Mundwasser | mouthwash
die Zähne; mpl | teeth
die Zahnbürste | toothbrush
die Zahnpasta | toothpaste

		beim optiker | the optician's
beim optiker | the optician's

der Augenarzt / die Augenärztin | ophthalmologist
die Lesebrille | reading glasses
die Bifokalbrille | bifocals
die harten / weichen Kontaktlinsen; fpl | hard / soft contact lenses
die Linse | lens
die Bindehautentzündung | conjunctivitis
das Gerstenkorn | stye
das verschwommene Sehen | blurred vision
kurzsichtig | short-sighted
weitsichtig | long-sighted
sehbehindert | visually impaired
blind | blind
farbblind | colour-blind
eine Brille tragen | to wear glasses
Kontaktlinsen tragen | to use contacts
die Kontaktlinsen; fpl | contact lenses
der Kontaktlinsenbehälter | contact lens case
die Sehtesttafel | eye chart
die Augentropfen; mpl | eye drops
der Sehtest | eye test
das Brillengestell | frames
die Brille | glasses
das Brillenetui | glasses case
der Optiker / die Optikerin | optician

		im krankenhaus | the hospital
im krankenhaus | the hospital

das Krankenhaus | hospital
die Notaufnahme | the emergency room
der Rettungswagen | ambulance
das öffentliche / private Krankenhaus | public / private hospital
der Krankenpfleger / die Krankenschwester | nurse
der Physiotherapeut / die Physiotherapeutin | physiotherapist
der Röntgenassistent / die Röntgenassistentin | radiographer
der Chirurg / die Chirurgin | surgeon
die Operation | operation
die CT­ / MRTUntersuchung | CT / MRI scan
die Intensivstation | intensive care
die Diagnose | diagnosis
der Puls | pulse
den Puls fühlen | to take his / her pulse
operiert werden | to undergo surgery
eingeliefert / entlassen werden | to be admitted / discharged
die Krücken; fpl | crutches
der Tropf | drip
das Krankenbett | hospital bed
der Monitor | monitor
der Operationssaal | operating theatre
die Sauerstoffmaske | oxygen mask
der Gipsverband | plaster cast
die Stiche; mpl | stitches
die Station | ward
der Rollstuhl | wheelchair
das Röntgenbild | X-ray
der Rollator | Zimmer frame®

		die schwangerschaft | pregnancy
die schwangerschaft | pregnancy

die Schwangere | pregnant woman
das Neugeborene | newborn
der Fötus | foetus
die Gebärmutter | uterus
der Gebärmutterhals | cervix
die Nabelschnur | umbilical cord
die Epiduralanästhesie | epidural
die Blähungen; fpl | gas and air
die Wehen; fpl | labour
die Geburt | delivery
der Kaiserschnitt | Caesarean section
die Fehlgeburt | miscarriage
tot geboren | stillborn
der Geburtstermin | due date
die Schwangerschaftsübelkeit | morning sickness
schwanger werden | to fall pregnant
in den Wehen liegen | to be in labour
ein Kind zur Welt bringen | to give birth
eine Fehlgeburt haben | to miscarry
stillen | to breast-feed

der Inkubator | incubator
der Kreißsaal | labour suite
die Hebamme | midwife
der Schwangerschaftstest | pregnancy test
der Ultraschalldiagnostiker / die Ultraschalldiagnostikerin | sonographer
der Ultraschall | ultrasound

		alternative therapien | alternative therapies
alternative therapien | alternative therapies

der Therapeut / die Therapeutin | therapist
der Masseur | masseur
die Masseurin | masseuse
der Chiropraktor / die Chiropraktorin | chiropractor
der Akupunkteur / die Akupunkteurin | acupuncturist
der Reflexologe / die Reflexologin | reflexologist
das Heilmittel | remedy
Reiki | reiki
die Achtsamkeit | mindfulness
sich entspannen | to relax
massieren | to massage
meditieren | to meditate

das ätherische Öl | essential oil
die Pflanzenheilkunde | herbal medicine
die Homöopathie | homeopathy

die Akupunktur | acupuncture
die Chiropraktik | chiropractic
die Hypnotherapie | hypnotherapy
die Massage | massage
die Meditation | meditation
die Osteopathie | osteopathy
die Reflexzonenmassage | reflexology
die Thalassotherapie | thalassotherapy
die traditionelle chinesische Medizin | traditional Chinese medicine

		beim tierarzt | the vet
beim tierarzt | the vet

die Tierklinik | veterinary clinic
der Tierarzt / die Tierärztin | vet
das Haustier | pet
der Floh | flea
die Zecke | tick
die BandwurmBehandlung | tapeworm treatment
der Heimtierausweis | pet passport
die Quarantäne | quarantine
zum Tierarzt gehen | to go to the vet
mit einem Mikrochip versehen | to microchip
sterilisieren / kastrieren | to spay / neuter
einschläfern | to put to sleep
der Elisabeth­Kragen | E-collar
das Flohhalsband | flea collar
die Transportbox | pet carrier

	die erde | planet earth
die erde | planet earth

		das wesentliche | the basics
das Tier | animal
die Spezies | species
das Säugetier | mammal
das Reptil | reptile
die Amphibie | amphibian
das Nagetier | rodent
das Insekt | insect
das Naturschutzgebiet | nature reserve
die Landschaft | scenery
der Zoo | zoo
das Fell | fur
die Wolle | wool
die Pfote | paw
der Huf | hoof
die Schnauze | snout
die Mähne | mane
der Schwanz | tail
die Kralle | claw
das Horn | horn
die Feder | feather
der Flügel | wing
der Schnabel | beak
kaltblütig | cold-blooded
warmblütig | warm-blooded
bellen | to bark
schnurren | to purr
knurren | to growl
brüllen | to roar
zwitschern | to chirp
summen | to buzz

		haustiere und vögel | domestic animals and birds
haustiere und vögel | domestic animals and birds
das Fischfutter | fish food
die Katzenstreu | cat litter
der Bauer / die Bäuerin | farmer
der Bauernhof | farm
die Scheune | barn
das Heu | hay
das Stroh | straw
die Wiese | meadow
die Herde | herd / flock
der Welpe | puppy
das Kätzchen | kitten
das Kalb | calf
das Lamm | lamb
das Fohlen | foal
der Blindenhund | guide dog
ein Haustier haben | to have a pet
den Hund ausführen | to walk the dog
eine Farm betreiben | to farm

der Wellensittich | budgerigar
der Kanarienvogel | canary
die Katze | cat
der Hund | dog
das Frettchen | ferret
der Goldfisch | goldfish
das Meerschweinchen | guinea pig
der Hamster | hamster
der Papagei | parrot
das Pony | pony
das Kaninchen | rabbit
die Ratte | rat

der Stier | bull
das Huhn | chicken
die Kuh | cow
der Esel | donkey
die Ente | duck
die Ziege | goat
die Gans | goose
das Pferd | horse
das Schwein | pig
das Schaf | sheep
der Schäferhund | sheepdog
der Truthahn | turkey

das Aquarium | aquarium
der Käfig | cage
die Katzenklappe | catflap
das Halsband | collar
der Hundekorb | dog basket
der Kaninchenstall | hutch
die Hundehütte | kennel
die Leine | lead
das Katzenklo | litter tray
der Maulkorb | muzzle
das Tierfutter | pet food
der Stall | stable

		amphibien und reptilien | amphibians and reptiles
amphibien und reptilien | amphibians and reptiles

der Alligator | alligator
das Krokodil | crocodile
der Frosch | frog
der Gecko | gecko
der Leguan | iguana
die Eidechse | lizard
der Wassermolch | newt
der Salamander | salamander
die Schlange | snake
die Kröte | toad
die Schildkröte | tortoise
die Wasserschildkröte | turtle

		säugetiere | mammals
säugetiere | mammals

der Dachs | badger
die Fledermaus | bat
das Wildschwein | boar
das Reh | deer
der Fuchs | fox
der Hase | hare
der Igel | hedgehog
der Maulwurf | mole
die Maus | mouse
der Otter | otter
das Eichhörnchen | squirrel
der Wolf | wolf
der Bär | bear
das Dromedar | camel
der Schimpanse | chimpanzee
der Elefant | elephant
die Giraffe | giraffe
der Gorilla | gorilla
das Nilpferd | hippopotamus
das Känguruh | kangaroo
der Löwe | lion
der Affe | monkey
das Nashorn | rhinoceros
der Tiger | tiger

		vögel | birds
vögel | birds
die Amsel | blackbird
der Bussard | buzzard
der Kranich | crane
der Rabe | crow
die Taube | dove
der Adler | eagle
der Fink | finch
der Flamingo | flamingo
die Möwe | gull
der Reiher | heron
der Eisvogel | kingfisher
die Lerche | lark
der Strauß | ostrich
die Eule | owl
der Pfau | peacock
der Pelikan | pelican
der Pinguin | penguin
die Taube | pigeon
der Papageitaucher | puffin
das Rotkehlchen | robin
der Spatz | sparrow
der Storch | stork
der Schwan | swan
die Drossel | thrush

		gliederfüßer | minibeasts
gliederfüßer | minibeasts
der Schwarm | swarm
die Kolonie | colony
das Spinnennetz | cobweb
der Stich | insect bite
summen | to buzz
stechen | to sting
die Ameise | ant
die Biene | bee
der Käfer | beetle
der Schmetterling | butterfly
die Raupe | caterpillar
der Tausendfüßler | centipede
die Küchenschabe | cockroach
die Grille | cricket
die Libelle | dragonfly
der Regenwurm | earthworm
die Fliege | fly
die Heuschrecke | grasshopper
der Marienkäfer | ladybird
die Eintagsfliege | mayfly
die Stechmücke | mosquito
die Motte | moth
die Nacktschnecke | slug
die Schnecke | snail
die Spinne | spider
die Wespe | wasp
die Kellerassel | woodlouse

		meerestiere | marine creatures
meerestiere | marine creatures
die Koralle | coral
die Krabbe | crab
der Delphin | dolphin
der Aal | eel
die Qualle | jellyfish
der Schwertwal | killer whale
der Hummer | lobster
der Seehund | seal
der Seeigel | sea urchin
der Hai | shark
der Seestern | starfish
der Wal | whale

		blumen, pflanzen und bäume | flowers, plants, and trees
blumen, pflanzen und bäume | flowers, plants, and trees

der Stiel | stalk
das Blatt | leaf
das Blütenblatt | petal
der Pollen | pollen
das Gras | grass
die Knospe | bud
die Blumenzwiebel | bulb
das Holz | wood
der Zweig | branch
der Baumstamm | trunk
die Borke | bark
die Wurzel | root

die Butterblume | buttercup
die Nelke | carnation
die Chrysantheme | chrysanthemum
die Osterglocke | daffodil
das Gänseblümchen | daisy
der Löwenzahn | dandelion
das Edelweiß | edelweiss
die Hyazinthe | hyacinth
die Iris | iris
die Lilie | lily
das Maiglöckchen | lily-of-the-valley
die Orchidee | orchid
das Stiefmütterchen | pansy
die Mohnblume | poppy
die Rose | rose
die Sonnenblume | sunflower
die Tulpe | tulip
das Veilchen | violet

die Kastanie | chestnut
die Zypresse | cypress
die Tanne | fir
der Pilz | fungus
der Weinstock | grapevine
der Efeu | ivy
das Moos | moss
die Eiche | oak
die Kiefer | pine
die Platane | plane
die Pappel | poplar
die Weide | willow

		land, meer und himmel | land, sea, and sky
land, meer und himmel | land, sea, and sky

die Landschaft | landscape
die Erde | soil
der Schlamm | mud
das Wasser | water
die Mündung | estuary
die Luft | air
die Atmosphäre | atmosphere
der Komet | comet
der Sonnenaufgang | sunrise
der Sonnenuntergang | sunset
ländlich | rural
städtisch | urban
Polar- | polar
alpin | alpine
tropisch | tropical

die Höhle | cave
die Wüste | desert
das Ackerland | farmland
der Wald | forest
der Gletscher | glacier
das Grasland | grassland
der Hügel | hill
der See | lake
der Sumpf | marsh
der Berg | mountain
der Teich | pond
der Fluss | river
das Gestein | rocks
das Buschland | scrub
der Bach | stream
das Tal | valley
der Vulkan | volcano
der Wasserfall | waterfall

die Klippe | cliff
die Küste | coast
das Korallenriff | coral reef
die Insel | island
die Halbinsel | peninsula
der Gezeitentümpel | rockpool

das Polarlicht | aurora
die Wolken; fpl | clouds
der Mond | moon
der Regenbogen | rainbow
die Sterne; mpl | stars
die Sonne | sun

	feste und festtage | celebrations and festivals
feste und festtage | celebrations and festivals

		das wesentliche | the basics
die Gelegenheit | occasion
der Geburtstag | birthday
die Hochzeit | wedding
der Hochzeitstag | wedding anniversary
der Feiertag | public holiday
der religiöse Feiertag | religious holiday
die Feier | celebration
die Überraschungsparty | surprise party
gute / schlechte Nachrichten | good / bad news
feiern | to celebrate
eine Party geben | to throw a party
auf etwas anstoßen | to toast something
das Bukett | bouquet
die Pralinen; fpl | box of chocolates
die Fähnchen; ntpl | bunting
der Kuchen | cake
der Champagner | champagne
das Konfetti | confetti
die Dekorationen; fpl | decorations
das Feuerwerk | fireworks
das Geschenk | gift
die Grußkarte | greetings card
die Party | party
die Luftschlangen; fpl | streamers

		festtage | high days and holidays
festtage | high days and holidays

die Taufe | baptism
die Taufe | christening
der Bar Mitzwa | bar mitzvah
die Bat Mitzwa | bat mitzvah
die Babyparty | baby shower
die Geburt | birth
die Kindheit | childhood
der Schulanfang | first day of school
die Abschlussfeier | graduation
die Verlobung | engagement
die Ehe | marriage
die Scheidung | divorce
der Umzug | relocation
der Ruhestand | retirement
die Beerdigung | funeral
der Muttertag | Mother's Day
der Vatertag | Father's Day
der erste April | April Fool's Day
Allerheiligen | All Saints' Day
Diwali | Diwali
Ostern | Easter
der Eid al-Fitr | Eid-al-Fitr
Halloween | Halloween
Chanukka | Hanukkah
der Martinstag | Martinmas
der Maifeiertag | May Day
der Ramadan | Ramadan
der Rosenmontag | Rose Monday
das Erntedankfest | Thanksgiving
der Valentinstag | Valentine's Day

		weihnachten und neujahr | christmas and new year
weihnachten und neujahr | christmas and new year

der Heiligabend | Christmas Eve
der erste Weihnachtstag | Christmas Day
die Weihnachtskarte | Christmas card
das Weihnachtsessen | Christmas dinner
die Weihnachtskugel | bauble
das Lametta | tinsel
das Geschenk | present
der Neujahrstag | New Year's Day
die Neujahrskarte | New Year's card
die Weihnachtsbeleuchtung | Christmas lights
der Weihnachtsmarkt | Christmas market
der Weihnachtsbaum | Christmas tree
der Weihnachtsmann / Sankt Nikolaus | Father Christmas / Santa Claus
die Lebkuchen; mpl | gingerbread biscuits
der Glühwein | mulled wine
das Krippenspiel | Nativity play
die Weihnachtskrippe | Nativity scene
das Silvester | New Year's Eve
Sankt Nikolaus und Knecht Ruprecht | Saint Nicholas and Knecht Ruprecht
der Stollen | stollen
der Kranz | wreath

		karneval | carnival
karneval | carnival

die Kinderschminke | face paint
die Maske | mask
der Kopfschmuck | headdress
die Fastenzeit | Lent
der Fastnachtsdienstag | Shrove Tuesday
der Aschermittwoch | Ash Wednesday
der Karnevalswagen | carnival float
das Kostüm | costume
die Strohpuppe | effigy
der Jahrmarkt | funfair
der Karnevalsumzug | parade
der Straßenkünstler / die Straßenkünstlerin | street performer
