org.leo.dictionary.config.entity.ParseWords:de:de::%5C%7C:%3B:%3B:%5Ct::German+alphabet
	German alphabet
A | A
B | B
C | C
D | D
E | E
F | F
G | G
H | H
I | I
J | J
K | K
L | L
M | M
N | N
O | O
P | P
Q | Q
R | R
S | S
T | T
U | U
V | V
W | W
X | X
Y | Y
Z | Z
Ä | Ä
Ö | Ö
Ü | Ü
ß | ß
